#######################
##
## License goes here
##
#######################
a	A
aacht	a:Xt
aachte	a:Xt@
aachten	a:Xt@n
aangel	a:N@l
aangelkreepche	a:N@lkRe:ps\@
aangelkreepchen	a:N@lkRe:ps\@n
aarbecht	a:Rb@s\t
aarbechter	a:Rb@s\t6
aarbechterinne	a:Rb@s\t@Rin@
aarbechtskolleeginne	a:Rb@s\tskole:z\in@
aarbechtskolleg	a:Rb@s\tskole:s\
aarbechtskolleginne	a:Rb@s\tskole:z\in@
aarbechtslost	a:Rb@s\tslo:st
aarbechtsministär	a:Rb@s\tsministE:R
aarbechtsplaz	a:Rb@s\tspla:ts
aarbechtszäit	a:Rb@s\tsts{:It
aarm	a:Rm
aarmbandauer	a:RmbAndAU6
aarme	a:Rm@
aarmséileg	a:Rms3Il@s\
aarmutsituatiounen	a:Rmutzitwa:tsj@Un@n
aarmutsrisiko	a:RmutsRiziko:
aarmutt	a:Rmut
aart	a:Rt
aartlech	a:Rtl@s\
aascht	a:St
aaxt	a:kst
abatjour	Aba:Zu:R
abattement	AbAt@mA~:
abattemente	AbAt@mA~:@
abattementen	AbAt@mA~:@n
abberzuel	Ab6tsu@l
abc	a:be:tse:
abee	Abe:
abegräife	Ab@gR{:If@
abegräifen	Ab@gR{:If@n
abendmahl	a:b@ntma:l
abenteuer	a:b@ntoI6
abezuele	Ab@tsu@l@
abezuelen	Ab@tsu@l@n
abgöttesch	Abg2t@S
abiméiere	Abim3I@R@
abiméieren	Abim3I@R@n
abléck	Ablek
abonnentinne	Abon{ntin@
abrëll	AbR@l
abrëllsgeck	AbR@lsg{k
abriecherinne	AbRi@s\@Rin@
abroch	AbRoX
abscheilech	ApSAIl@s\
absenteismus	Abz{nte:ismus
absichtlech	Apzis\tl@s\
absolutt	Apzolut
absolventinne	Abzolv{ntin@
abstraéiert	AbstRA3I6t
abstraéiertes	AbstRA3I6t@s
abstrakt	AbstRAkt
absurd	ApzuRt
äbtissinne	{ptisin@
abus	Aby:
abuse	Aby:@
abusen	Aby:@n
acceleratioun	Aksel@RAtsj@Un
acceleratiounen	Aks{l@Ra:tsj@Un@n
acceleréier	Aksel@R3I6
acceleréiere	Aksel@R3I@R@
accent	AksA~:
accentuéier	AksA~:ty3I6
accentuéiere	AksA~:ty3I@R@
accentuéieren	AksA~:ty3I@R@n
accès	AksE:
accèse	AksE:@
accèsen	AksE:@n
accessibeles	Aks{sib@l@s
accident	Aksid{nt
accisë	Aksi:z@
accisen	Aksi:z@n
accord	AkO:R
accouchéiere	AkuS3I@R@
accouchéieren	AkuS3I@R@n
accouchement	AkuS@m{nt
accroc	AkRo:
accueil	Ak9j
accueile	Ak9j@
accueilen	Ak9j@n
accumuléiere	Akymyl3I@R@
accumuléieren	Akymyl3I@R@n
achterbunn	AXt6bun
achtkanteges	AXtkAnt@z\@s
achzeg	AXts@s\
acompte	AkA~:nt
acomptë	AkA~:nt@
acompten	AkA~:nt@n
acompter	AkA~:nt6
acquis	Aki:
acquise	Aki:@
acquisen	Aki:@n
acquisitioun	Akizitsj@Un
acquittéiere	Akit3I@R@
acteur	Akt9:R
acteure	Akt9:R@
actionnairinne	Aksjo:nE:Rin@
äddi	{di:
äddie	{di:@
äddien	{di:@n
adeleg	a:d@l@s\
adelege	a:d@l@z\@
adequaatst	Adekwa:tst
adequaatste	Adekwa:tst@
adhésioun	Athe:zj@Un
adjektiv	Atjekti:f
adjoint	AdZwE~:
adjointë	AdZwE~:@
adjointe	AdZwE~:nt
adjointeë	AdZwE~:nt@
adjointeën	AdZwE~:nt@n
adjointen	AdZwE~:@n
adjutant	AdZu:tAnt
adjutante	AdZu:tAnt@
adjutanten	AdZu:tAnt@n
adjutantin	AdZu:tAntin
adjutantinne	Adju:tAntin@
adjutantinne	AdZu:tAntin@
adjutantinnen	AdZu:tAntin@n
adler	a:dl6
admirolinne	a:tmiRo:lin@
adolphe	Adolf
adoptéiere	Adopt3I@R@
adoptéieren	Adopt3I@R@n
adoptiounsfamill	Adoptj@UnsfAmil
adoptiounsfamille	Adoptj@UnsfAmil@
adoptivjongen	Adopti:fjoN@n
adoptivkand	Adopti:fkAnt
adoptivmamme	Adopti:fmAm@
adress	AdR{s
adressate	AdR{sAt
adresséiere	AdR{s3I@R@
adresséieren	AdR{s3I@R@n
adriatesches	AdRja:t@S@s
adventskalenner	Adv{ntskAl{n6
ae	a:@
aen	a:@n
aendeckel	a:@nd{k@l
aendokter	a:@ndokt6
äerd	E:6t
äerdbier	E:6tbi6
äerdbiewe	E:6tbi@v@
äerdbiewen	E:6tbi@v@n
äerdeg	E:6d@s\
äerdejoer	E:6d@jo:6
aerobic	E:Robik
aerodynamesch	E:Ro:dina:m@S
aerodynamik	a:@Ro:dinAmik
äert	E:6t
af	a:f
afaalt	Afa:lt
afalen	Afa:l@n
afe	a:f@
afeger	a:f@z\6
afegst	a:f@s\st
afegste	a:f@s\st@
afëllen	Af@l@n
afen	a:f@n
affär	AfE:R
affekot	Af@ko:t
affekotecabinet	Af@ko:t@kAbine:
affekotinne	Af@ko:tin@
affer	Af6
affere	Af@R@
afferen	Af@R@n
afferstack	Af6StAk
affichagë	AfiSa:Z@
affinitéit	Afinit3It
affirmativem	AfiRmAti:v@m
affisch	AfiS
affischéiere	AfiS3I@R@
affischéieren	AfiS3I@R@n
afganistan	Afga:nista:n
afoul	Af@Ul
afoulen	Af@Ul@n
afouls	Af@Uls
afoult	Af@Ult
afüge	Afy:z\@
afügen	Afy:z\@n
agank	AgANk
agebaute	Ag@b{:Ut
agebilt	Ag@bilt
agebilte	Ag@bilt@
agebilten	Ag@bilt@n
agebuerene	Ag@bu@R@n@
agebuerenen	Ag@bu@R@n@n
agecheckt	AgetS{kt
agecheckte	AgetS{kt@
agechecktem	AgetS{kt@m
agenda	AZ{nda:
agentinne	Ag{ntin@
agestoe	Ag@Sto:@
agestoen	Ag@Sto:@n
agoe	Ago:@
agoen	Ago:@n
agréabel	AgRea:b@l
agreabele	AgRea:b@l@
agreabelem	AgRea:b@l@m
ähnlech	E:nl@s\
ahor	a:o:R
ahorn	a:hORn
ahorne	a:hORn@
aide	E:t
aiden	E:d@n
aids	3Its
äis	{:Is
äisbier	{:Isbi6
äiseg	{:Iz@s\
äisege	{:Iz@z\@
äisegem	{:Iz@z\@m
äisegen	{:Iz@z\@n
äiser	{:Iz6
äiskal	{:Iska:l
äiskonschtleeferinne	{:IskonStle:f@Rin@
äisschongfuere	{:IsSoNfu@R@
äisschongfueren	{:IsSoNfu@R@n
ajustéiere	AZyst3I@R@
ajustéieren	AZyst3I@R@n
akachs	AkAXs
akacht	AkAXt
akademikerinne	Aka:de:mik@Rin@
akaf	Aka:f
akafe	Aka:f@
akafen	Aka:f@n
akafskuerf	Aka:fsku@f
akafsweenche	Aka:fsve:ns\@
akafsweenchen	Aka:fsve:ns\@n
akaul	a:kAUl
akkord	AkOXt
akkorden	AkORd@n
akkordeon	AkORde:A~:
akkordeone	AkORde:A~:@
akkordeonen	AkORde:A~:@n
akkordeonistinne	AkoRde:onistin@
akku	Aku:
akkue	Aku:@
akkuen	Aku:@n
aklamme	AklAm@
aklammen	AklAm@n
aklemme	Akl{m@
aklemmen	Akl{m@n
akrobat	AkRo:ba:t
akrobat	AkRoba:t
akrobate	AkRo:ba:t@
akrobaten	AkRo:ba:t@n
akrobatinne	AkRo:ba:tin@
akt	Akt
aktie	Aksj@
aktien	Aksj@n
aktionärinne	Aksjo:nE:Rin@
aktioun	Aksj@Un
aktiv	Akti:f
aktiven	Akti:v@n
aktiver	Akti:v6
aktivistinne	Aktivistin@
aktivitéit	Aktivit3It
aktuell	Aktw{l
al	a:l
aläert	AlE:6t
alain	AlE~:
alarm	AlARm
album	Album
ale	a:l@
alen	a:l@n
alertéiere	Al{Rt3I@R@
alertéieren	Al{Rt3I@R@n
alg	Als\
alge	Alz\@
algen	Alz\@n
alibien	a:libi:@n
aliichte	Ali:s\t@
aliichten	Ali:s\t@n
alkohol	Alkoho:l
alkohol	Alkohol
alkohole	Alkoho:l@
alkoholikerinne	Alkoho:lik@Rin@
all	Al
allebéid	Al@b3It
alleguer	Al@gu6
allergië	Al{RZi:@
allergien	Al{RZi:@n
allerhellge	Al6h{lz\@
allerhellgen	Al6h{lz\@n
allerlee	Al6le:
allerséile	Al6z3Il@
allerséilen	Al6z3Il@n
alles	Al@s
allgemeng	Alg@m{N
allianz	AljAnts
allianze	AljAnts@
allianzen	AljAnts@n
alliéierten	Alj3I6t@n
alliéierter	Alj3I6t6
allo	Alo:
allür	Aly:R
allüre	Aly:R
allure	Aly:R@
allurë	Aly:R@
alluren	Aly:R@n
almose	Almo:z@
almosen	Almo:z@n
almoudesch	a:lm@Ud@S
alpinistinne	Alpinistin@
als	Als
also	Alzo:
alstad	a:lSta:t
alter	Alt6
alternativ	AltE6nAti:f
altertum	Alt6tum
altesse	Alt{s
altessen	Alt{s@n
aluede	Alu@d@
alueden	Alu@d@n
aluminium	Alyminjum
am	Am
amaache	Ama:X@
amaachen	Ama:X@n
amaachglas	Ama:Xgla:s
amant	AmA~:
amante	AmA~:@
amanten	AmA~:@n
amass	AmAs
amateur	AmAt9:R
ambassad	AmbAsa:t
ambassadë	A~:mbAsa:d@
ambassade	A~:mbAsa:t
ambassaden	A~:mbAsa:d@n
ambassadeur	A~:mbAsAd9:R
ambigu	A~:mbigy:
ambigue	A~:mbigy:@
ambiguem	A~:mbigy:@m
ambiguen	A~:mbigy:@n
ambiguitéit	A~:mbigy:it3It
ambiguitéite	A~:mbigy:it3It
ambiguitéiten	A~:mbigy:it3It@n
ambitiéis	A~:mbisj3Is
ambitiéise	A~:mbisj3Iz@
ambulanz	AmbulAnts
améchs	Am@s\s
amelioratioun	Ameljo:RAtsj@Un
amen	a:m@n
amenagéiere	Amena:Z3I@R@
amenagéieren	Amena:Z3I@R@n
amendéier	AmA~:nd3I6
amendéieren	AmA~:nd3I@R@n
amendement	AmA~:nd@mA~:
ament	Am{nt
amerika	Ame:Rika:
amësche	Am@S@
amëschen	Am@S@n
ameséiere	Am@z3I@R@
ameséieren	Am@z3I@R@n
amgaang	Amga:N
amicalle	AmikAl@
amicallen	AmikAl@n
amnestie	Amn{sti:
amnestië	Amn{sti:@
amok	Amok
amokleeferinne	Amokle:f@Rin@
amortiséiere	AmORtiz3I@R@
amortiséieren	AmORtiz3I@R@n
amortisseur	AmORtis9:R
amplaz	Ampla:ts
ampull	Ampul
amusant	AmuzAnt
amusantem	AmuzAnt@m
amüsantem	AmysAnt@m
amüsantst	AmysAntst
amusantste	AmuzAntst@
amusement	Amuz@m{nt
an	An
anachronismen	AnAkRonism@n
analoger	Ana:lo:R6
analogie	Ana:lo:Zi:
analogië	Ana:lo:Zi:@
analogië	Ana:loZi:@
analogien	Ana:lo:Zi:@n
analoogt	Ana:lo:Xt
analphabet	AnAlfa:be:t
analphabete	AnAlfa:be:t@
analphabeten	AnAlfa:be:t@n
analphabetin	Ana:lfa:be:tin
analphabetinne	Ana:lfa:b@tin@
analyse	Ana:li:z@
analytikerinne	Ana:litik@Rin@
ananas	AnAna:s
anarchie	AnARs\i@
anarchistinne	Ana:Rs\istin@
anäscheren	An{S@R@n
anästhesie	AnE:ste:zi:
anästhesië	AnE:ste:zi:@
anästhesistinne	AnE:ste:sistin@
anchecken	AntS{k@n
anchoisen	A~:SwA@n
anekdot	An{kdo:t
aneneen	An@ne:n
aner	a:n6
anere	a:n@R@
aneren	a:n@R@n
anescht	a:n@St
angab	Anga:p
angabe	Anga:b@
angine	A~:Zin
anginne	A~:Zin@
angscht	ANSt
ängschtlech	{NStl@s\
animateur	AnimAt9:R
animéiere	Anim3I@R@
animéieren	Anim3I@R@n
anker	ANk6
ännere	{n@R@
änneren	{n@R@n
ännerung	{n@RuN
anniichter	Ani:s\t6
anniversaire	Ani:v{RsE:R
anniversairë	Ani:v{RsE:R@
anniversairen	Ani:v{RsE:R@n
annonce	AnA~:s
annoncéiere	AnA~:s3I@R@
annoncéieren	AnA~:s3I@R@n
annuléiere	Anyl3I@R@
annuléieren	Anyl3I@R@n
anomalie	Anoma:li:
anomalië	Anoma:li:@
anonymmen	Anonim@n
anorak	AnoRAk
anormal	AnORma:l
anotems	Ano:t@ms
anotemt	Ano:t@mt
antenn	Ant{n
antenne	A~:nt{n@
antennen	A~:nt{n@n
antëscht	Ant@St
antibiotique	Anti:bjotik
antibiotiquë	Anti:bjotik@
antibiotiquen	Anti:bjotik@n
anticke	Antik@
antickem	Antik@m
antik	Anti:k
antik	Antik
antikst	Antikst
antippe	Antip@
antippen	Antip@n
antisemitesch	Anti:ze:mit@S
antisemitinne	Anti:ze:mitin@
antivol	A~:ntivol
antriichtere	AntRi:s\t@R@
antriichteren	AntRi:s\t@R@n
äntwere	{ntv@R@
äntweren	{ntv@R@n
äntwert	{ntv6t
anzeblende	Ants@bl{nd@
anzeblenden	Ants@bl{nd@n
anzeblenne	Ants@bl{n@
anzeblennen	Ants@bl{n@n
anzebrénge	Ants@bReN@
anzebréngen	Ants@bReN@n
anzebrenne	Ants@bR{n@
anzesange	Ants@zAN@
anzwousch	Antsw@US
apaart	Apa:Rt
apake	Apa:k@
apaken	Apa:k@n
apdikt	Apdikt
apdikter	Apdikt6
apel	a:p@l
apendelen	Ap@nd@l@n
aperhoer	a:p6ho:6
apostel	Apost@l
apostele	Apost@l@
apostroph	ApostRof
apparat	ApARa:t
appartement	ApARt@m{nt
äppelbam	{p@lba:m
äppeljus	{p@lZy:
appetit	Ap@tit
appetitlech	Ap@titl@s\
applaus	AplAUs
approche	ApRoS
approchë	ApRoS@
approchen	ApRoS@n
approuvéiere	ApRuv3I@R@
approuvéieren	ApRuv3I@R@n
approximatiivt	ApRoksimAti:ft
approximativ	ApRoksimAti:f
approximative	ApRoksima:ti:v@
appui	ApHi:
apräägs	ApRE:s\s
aprägen	ApRE:z\@n
aprikos	ApRiko:s
aquaplaning	Akwa:pla:niN
aquarium	Akwa:Rium
äquator	e:kwa:to:R
är	E:R
arabesch	ARa:b@S
araume	ARAUm@
araumen	ARAUm@n
arbitter	ARbit6
arbitterinne	ARbit@Rin@
arcadë	ARka:d@
arcade	ARka:t
arcaden	ARka:d@n
archaesch	ARka:@S
archaeschen	ARka:@S@n
archeolog	ARke:o:lo:k
archeologe	ARke:o:lo:g@
archeologen	ARke:o:lo:g@n
archeologinne	ARke:o:lo:gin@
architekt	ARSit{kt
architektinne	ARs\it{ktin@
architektur	ARs\it{ktu:6
architekture	ARs\it{ktu:R@
architekturen	ARs\it{ktu:R@n
archiv	ARs\i:f
archive	ARs\iv@
archivistinne	ARs\ivistin@
äre	E:R@
arem	a:R@m
ären	E:R@n
arenne	AR{n@
arennen	AR{n@n
ärer	E:R6
ariichte	ARi:s\t@
ariichten	ARi:s\t@n
aristokratinne	ARistokRa:tin@
arméi	ARm3I
arrêt	ARE:
arrêté	ARe:te:
arrête	ARE:@
arrêtéë	ARe:te:@
arrêtéen	ARe:te:@n
arrêten	ARE:@n
arrivée	ARive:
arrogant	ARo:gAnt
arrogante	ARo:gAnt@
arterie	ARte:Rj@
arterien	ARte:Rj@n
arthrite	ARtRit
artichaut	ARtiSo:
artikel	ARtik@l
artist	ARtist
artisteschste	ARtist@Sst@
artisteschstem	ARtist@Sst@m
artisteschsten	ARtist@Sst@n
artisteschster	ARtist@Sst6
artistinne	ARtistin@
asammele	AzAm@l@
asammelen	AzAm@l@n
asazfäegster	Aza:tsfE:@s\st6
asazfäegt	Aza:tsfE:@s\t
asazfäheg	Aza:tsfE:@s\
äsche	{S@
äschebecher	{S@b{s\6
äschen	{S@n
äschenteller	{S@nt{l6
aschloe	ASlo:@
aschloen	ASlo:@n
aschlofe	ASlo:f@
aschlofen	ASlo:f@n
aspaans	ASpa:ns
aspaant	ASpa:nt
aspäre	ASpE:R@
aspären	ASpE:R@n
aspekt	Asp{kt
aspro	AspRo:
assistentinne	Asist{ntin@
assitant	AsistA~:
associé	Asosie:
associée	Asosje:
associéë	Asosje:@
associéeë	Asosje:@
associéeën	Asosje:@n
assurance	AsyRA~:s
assuréiere	AsyR3I@R@
assuréieren	AsyR3I@R@n
astéings	ASt3INs
astéingt	ASt3INt
astelle	ASt{l@
astellen	ASt{l@n
ästhet	{ste:t
asthma	Astma:
astouch	ASt@UX
astoungen	ASt@UN@n
astoungs	ASt@UNs
astrolog	AstRolo:X
astrologe	AstRolo:R@
astrologen	AstRolo:R@n
astrologinne	AstRolo:gin@
astronaut	AstRonAUt
astronautinne	AstRonAUtin@
asylantinne	AsilAntin@
atelier	At@lie:
atelier	At@lje:
ateliere	At@lje:@
atheistinne	Ate:istin@
athlet	Atle:t
athletinne	Atle:tin@
atlas	AtlAs
atom	Ato:m
atomreakter	Ato:mReAkt6
atoute	Atu:@
atouten	Atu:@n
attentat	At@nta:t
attentater	At@nta:t6
attentäterinne	AtA~:tE:t@Rin@
atter	At6
attitude	Atity:t
attitudë	Atityd@
attraktioun	AtRAksj@Un
aubergine	o:bERZin
auberginne	o:bERZin@
auder	AUd6
audienz	AUdj{nts
audienze	AUdj{nts@
audiovisuell	AUdjo:vi:zw{l
auditoire	o:ditwa:R
auditoirë	o:ditwa:R@
auer	AU6
auermécher	AU6m@s\6
aufgab	AUfga:p
aufsatz	AUfsAts
august	AUgust
aus	{:Us
ausbaue	{:UsbAU@
ausbauen	{:UsbAU@n
ausbehale	{:Usb@ha:l@
ausbehalen	{:Usb@ha:l@n
ausdeele	{:Usde:l@
ausdeelen	{:Usde:l@n
ausdoe	{:Usdo:@
ausdoen	{:Usdo:@n
ausdrécke	{:UsdRek@
ausdrécken	{:UsdRek@n
ausdrock	{:UsdRok
auserhéngert	{:Uz6heN6t
ausernee	{:Uz6ne:
auserneen	{:Uz6ne:n
ausféiere	{:Usf3I@R@
ausféieren	{:Usf3I@R@n
ausfëlle	{:Usf@l@
ausfëllen	{:Usf@l@n
ausflug	{:UsfluX
ausgab	{:Usga:p
ausgebeut	{:Usg@boIt
ausgebeute	{:Usg@boIt@
ausgerechent	{:Usg@R{s\@nt
ausgesinn	{:Usg@zin
ausginn	{:Usgin
ausgoe	{:Usgo:@
ausgoen	{:Usgo:@n
aushéngere	{:UsheN@R@
aushéngeren	{:UsheN@R@n
aushoul	{:Ush@Ul
aushoulen	{:Ush@Ul@n
aushouls	{:Ush@Uls
aushoult	{:Ush@Ult
aushoung	{:Ush@UN
aushoungen	{:Ush@UN@n
auskräischs	{:UskR{:ISs
auslafe	{:Usla:f@
auslafen	{:Usla:f@n
ausland	{:UslAnt
auslänner	{:Usl{n6
auslännerinne	{:Usl{n@Rin@
auslännesch	{:Usl{n@S
auslous	{:Usl@Us
auslouse	{:Usl@Us
auslousen	{:Usl@Uz@n
ausloust	{:Usl@Ust
ausluede	{:Uslu@d@
auslueden	{:Uslu@d@n
ausmaache	{:Usma:X@
ausmaachen	{:Usma:X@n
ausnahm	{:Usna:m
ausnotze	{:Usnots@
ausnotzen	{:Usnots@n
auspäife	{:Usp{:If@
auspäifen	{:Usp{:If@n
auspéile	{:Usp3Il@
auspéilen	{:Usp3Il@n
auspuff	{:Uspuf
ausraibere	{:UsRAIb@R@
ausraiberen	{:UsRAIb@R@n
ausraume	{:UsRAUm@
ausraumen	{:UsRAUm@n
ausrechne	{:UsR{s\n@
ausrechnen	{:UsR{s\n@n
ausrësele	{:UsR@z@l@
ausrëselen	{:UsR@z@l@n
ausrësserinne	{:UsR@s@Rin@
ausriede	{:UsRi@d@
ausrieden	{:UsRi@d@n
ausrifferinne	{:UsRif@Rin@
ausroue	{:UsR@U@
ausrouen	{:UsR@U@n
ausrutsche	{:UsRutS@
ausrutschen	{:UsRutS@n
ausschëdde	{:UsS@d@
ausschëdden	{:UsS@d@n
ausschlaggebend	{:UsSla:Xge:b@nt
ausschlaggebende	{:UsSla:Xge:b@nd@
ausschlaggebendem	{:UsSla:Xge:b@nd@m
ausschlaggebenden	{:UsSla:Xge:b@nd@n
ausschlofe	{:UsSlo:fe
ausschlofen	{:UsSlo:fen
ausschnëtt	{:UsSn@t
ausseministerinne	{:Us@minist@Rin@
ausser	{:Us6
aussergewéinlech	{:Us6g@v3Inl@s\
äusserlech	oIs6l@s\
ausseruerdentlech	{:Us6u6d@ntl@s\
ausseruerdentleche	{:Us6u6d@ntl@s\@
ausseruerdentlechem	{:Us6u6d@ntl@s\@m
ausseruerdentlechen	{:Us6u6d@ntl@s\@n
ausseruerdentlecher	{:Us6u6d@ntl@s\6
ausseruerdentlechst	{:Us6u6d@ntl@s\st
äusserung	oIs6RuN
aussesäiterinne	{:Usz@z{:It@Rin@
ausso	{:Uszo:
ausspane	{:UsSpa:n@
ausspanen	{:UsSpa:n@n
aussprieche	{:UsSpRi@s\@
ausspriechen	{:UsSpRi@s\@n
aussprooch	{:UsSpRo:X
ausstelle	{:UsSt{l@
ausstellen	{:UsSt{l@n
ausstellerinne	{:UsSt{l@Rin@
ausstellung	{:UsSt{luN
ausstierwe	{:UsSti@v@
ausstierwen	{:UsSti@v@n
auswäiche	{:Usv{:Is\@
auswäichen	{:Usv{:Is\@n
auswanderinne	{:UsvAnd@Rin@
auswenneg	{:Usv{n@s\
auswësche	{:Usv@S@
auswëschen	{:Usv@S@n
auswiel	{:Usvi@l
auszedoe	{:Usts@do:@
auszepake	{:Usts@pa:k@
autant	o:tA~:
auteur	o:t9:R
auto	AUto:
autobunn	AUto:bun
autobunnssortie	AUto:bunssORti:
autofuerer	AUto:fu@R6
automobilistinne	AUto:mobilistin@
autorinne	AUto:Rin@
avancen	AvA~:s@n
avantage	AvA~:ta:S
avenue	Av@ny:
avenuen	Av@ny:@n
averstan	Af6Sta:n
avertéieren	Av{Rt3I@R@n
avertéiers	Av{Rt3I6s
avis	Avi:
avise	Avi:@
avisen	Avi:@n
awanderinne	AvAnd@Rin@
awar	Ava:R
aweeche	Ave:s\@
aweechen	Ave:s\@n
aweie	AvAI@
aweien	AvAI@n
awëllege	Av@l@z\@
awëllegen	Av@l@z\@n
awëllegung	Av@l@z\uN
awer	a:v6
awerglaf	a:v6gla:f
awuer	Avu6
awunner	Avun6
awunnerinne	Avun@Rin@
baach	ba:X
baang	ba:N
baarbes	ba:Rb@s
baarf	ba:Rf
baarmhäerzegkeet	ba:RmhE:6ts@s\ke:t
baart	ba:Rt
baartbiischt	ba:Rtbi:St
baasch	ba:S
babbele	bAb@l@
babbelen	bAb@l@n
babysitterinne	bAbi:sit@Rin@
bäcker	b{k6
bäckerei	b{k@RAI
bäckesch	b{k@S
bad	ba:t
badgë	b{dZ@
badge	b{tS
badgen	b{dZ@n
baffe	bAf@
baffen	bAf@n
bagage	bAga:S
bagger	bAg6
bäichelche	b{:Is\@ls\@
bäichelchen	b{:Is\@ls\@n
baichelcher	bAIs\@ls\6
bäiginn	b{:Igin
bäigoe	b{:Igo:@
bäigoen	b{:Igo:@n
bäilafe	b{:Ila:f@
bäilafen	b{:Ila:f@n
bäilagen	b{:Ila:R@n
bäileed	b{:Ile:t
bäiluegt	b{:Ilu@s\t
bäisse	b{:Is@
baisse	b{s
bäissen	b{:Is@n
bäiwunne	b{:Ivun@
bäiwunnen	b{:Ivun@n
bak	ba:k
bake	ba:k@
baken	ba:k@n
bakzant	ba:ktsAnt
bal	ba:l
balkon	bAlkA~:
ball	bAl
ballet	bAle:
ballon	bAlA~:
balucke	bAluk@
balucken	bAluk@n
bam	ba:m
bampele	bAmp@l@
bampelen	bAmp@l@n
bamstamm	ba:mStAm
banal	bAna:l
banane	bAnAn
band	bAnt
bandage	bAnda:S
banditinne	bAnditin@
bänk	b{Nk
bank	bANk
bänke	b{Nk@
banke	bANk@
bänken	b{Nk@n
banken	bANk@n
bankerinne	b{Nk@Rin@
banne	bAn@
bannen	bAn@n
bannendes	bAn@nd@s
bannenhaff	bAn@nhAf
bänner	b{n6
baroninne	bARo:nin@
barrage	bARa:S
barrière	bARiE:R
bascht	bASt
baschte	bASt@
baschten	bASt@n
basis	ba:zis
basketspillerinne	bAsk{tSpil@Rin@
baskett	bAsk{t
bass	bAs
bassistinne	bAsistin@
bastele	bAst@l@
bastelen	bAst@l@n
bastlerinne	bAstl@Rin@
bataklang	bAtAklAN
batter	bAt6
batterie	bAt@Ri:
bätz	b{ts
batz	bAts
bau	b{:U
bauaarbechterinne	bAUa:Rb@s\t@Rin@
bauch	b{:UX
baue	bAU@
bauen	bAU@n
bauer	bAU6
bauerenhaff	bAU@R@nhAf
baufälleg	b{:Uf{l@s\
baukaste	bAUkAst@
baukasten	bAUkAst@n
baupse	bAUps@
baupsen	bAUps@n
bauscheg	b{:US@s\
bausse	b{:Us@
baussen	b{:Us@n
beaaften	b@a:ft@n
beaarbecht	b@a:Rb@s\t
beaarbechte	b@a:Rb@s\t@
beafe	b@a:f@
beafloss	b@Aflos
beamt	bi:mt
beamte	b@Amt@
beamtebeleidegung	b@Amt@b@lAId@z\uN
beamten	b@Amt@n
beandrock	b@AndRok
beandrocke	b@AndRok@
beängschtegend	b@{NSt@z\@nt
beäntwer	b@{ntv6
beäntwere	b@{ntv@R@
beauté	bo:te:
becher	b{s\6
béchs	beks
béchse	beks@
béchsefleesch	beks@fle:S
béchsen	beks@n
béchsenöffner	beks@n9fn6
bécke	bek@
bécken	bek@n
bedauere	b@dAU@R@
bedaueren	b@dAU@R@n
bedauerlech	b@dAU6l@s\
bedeite	b@dAIt@
bedeiten	b@dAIt@n
bedeitend	b@dAIt@nt
bedierfnesser	b@di6fn@s6
bedrécke	b@dRek@
bedrécken	b@dRek@n
bedreckse	b@dR{ks@
bedrecksen	b@dR{ks@n
bedupse	b@dups@
bedupsen	b@dups@n
bee	be:
beeme	be:m@
beemen	be:m@n
been	be:n
bees	be:s
beesen	be:s@n
befriddegend	b@fRid@z\@nt
begaabt	b@ga:pt
begeeschtert	b@ge:St6t
begeeschterung	b@ge:St@RuN
begéine	b@g3In@
begéinen	b@g3In@n
begleede	b@gle:d@
begleeden	b@gle:d@n
begradegen	b@gRa:d@z\@n
begräife	b@gR{:If@
begräifen	b@gR{:If@n
begréisse	b@gR3Is@
begréissen	b@gR3Is@n
begréissung	b@gR3IsuN
begriefnes	b@gRi@fn@s
begruewe	b@gRu@v@
begruewen	b@gRu@v@n
behaapte	b@ha:pt@
behaapten	b@ha:pt@n
behandele	b@hAnd@l@
behandelen	b@hAnd@l@n
behenn	b@h{n
behuele	b@hu@l@
behuelen	b@hu@l@n
bei	bAI
béie	b3I@
beiekinniginne	bAI@kinigin@
béien	b3I@n
beienee	bAI@ne:
beieneen	bAI@ne:n
beienziichterinne	bAI@ntsi:s\t@Rin@
béier	b3I6
beiestack	bAI@StAk
beifall	bAIfAl
beige	bE:S
beil	bAIl
beim	bAIm
béis	b3Is
beispill	bAISpil
bejoe	b@jo:@
bejoen	b@jo:@n
bekannt	b@kAnt
bekannte	b@kAnt@
bekannten	b@kAnt@n
bekanntschaft	b@kAntSAft
bekäppe	b@k{p@
bekäppen	b@k{p@n
bekéierunge	b@k3I@RuN@
bekloe	b@klo:@
bekloen	b@klo:@n
bekucke	b@kuk@
bekucken	b@kuk@n
belagere	b@la:g@R@
belageren	b@la:g@R@n
belästege	b@l{st@z\@
belästegen	b@l{st@z\@n
beléie	b@l3I@
beléien	b@l3I@n
belibeg	b@li:b@s\
beliichte	b@li:s\t@
beliichten	b@li:s\t@n
beliichtung	b@li:s\tuN
bëlleg	b@l@s\
beloune	b@l@Un@
belounen	b@l@Un@n
belounung	b@l@UnuN
belsch	b{lS
bemustere	b@must@R@
bemusteren	b@must@R@n
bëndelche	b@nd@ls\@
bëndelchen	b@nd@ls\@n
beneiden	b@nAId@n
benevol	benevol
bengel	b{N@l
beniwwelen	b@niv@l@n
benotze	b@nots@
benotzen	b@nots@n
benotzerinne	b@nots@Rin@
benotzerrotschlag	b@nots6Ro:tSla:X
bensin	b{nzin
bensinspompel	b{nzinspomp@l
bensinsstatioun	b{nzinsSta:tsj@Un
berappe	b@RAp@
berappen	b@RAp@n
berechne	b@R{s\n@
berechnen	b@R{s\n@n
berechnung	b@R{s\nuN
beréiere	b@R3I@R@
beréieren	b@R3I@R@n
berode	b@Ro:d@
beroden	b@Ro:d@n
beroderinne	b@Ro:d@Rin@
berouege	b@R@U@z\@
berouegen	b@R@U@z\@n
berouegungsmëttel	b@R@U@z\uNsm@t@l
berri	b{Ri:
beruff	b@Ruf
beruffsgrupp	b@RufsgRup
berühmt	b@Ry:mt
besat	b@sa:t
bësch	b@S
bëschaarbechterinne	b@Sa:Rb@s\t@Rin@
beschäftegungssommet	b@S{ft@z\uNssome:
beschass	b@SAs
bescheed	b@Se:t
bescheide	b@SAId@
bescheiden	b@SAId@n
bescheinege	b@SAIn@z\@
bescheinegen	b@SAIn@z\@n
beschëllege	b@S@l@z\@
beschëllegen	b@S@l@z\@n
beschiedege	b@Si@d@z\@
beschiedegen	b@Si@d@z\@n
beschmiere	b@Smi@R@
beschmieren	b@Smi@R@n
bëschof	b@So:f
beschrëftung	b@SR@ftuN
beschreiwe	b@SRAIv@
beschreiwen	b@SRAIv@n
beschreiwung	b@SRAIvuN
beschte	b{St@
beschten	b{St@n
beschütze	b@Syts@
beschützen	b@Syts@n
beschwéiere	b@Sw3I@R@
beschwéieren	b@Sw3I@R@n
bëschzerstéierung	b@Sts6St3I@RuN
bësele	b@z@l@
bëselen	b@z@l@n
besetze	b@z{ts@
besetzen	b@z{ts@n
besëtzer	b@z@ts6
besëtzerinne	b@z@ts@Rin@
besiche	b@zis\@
besichen	b@zis\@n
besoff	b@zof
besoin	b@zwE~:
besonnesch	b@zon@S
bësse	b@s@
bëssen	b@s@n
besser	b{s6
besserer	b{s@R6
besseres	b{s@R@s
besserung	b{s@RuN
besserwësserinne	b{s6v@s@Rin@
bestelle	b@St{l@
bestellen	b@St{l@n
bestellung	b@St{luN
bestëmmt	b@St@mt
bestierzung	b@Sti6tsuN
bestietnes	b@Sti@tn@s
bestoe	b@Sto:@
bestoen	b@Sto:@n
bestrofe	b@StRo:f@
bestrofen	b@StRo:f@n
bestseller	b{sts{l6
bestuede	b@Stu@d@
bestueden	b@Stu@d@n
bestuet	b@Stu@t
besuch	b@zuX
besuddele	b@zud@l@
besuddelen	b@zud@l@n
betaaschte	b@ta:St@
betaaschten	b@ta:St@n
bëtong	b@toN
betoune	b@t@Un@
betounen	b@t@Un@n
betounung	b@t@UnuN
betrib	b@tRi:p
bett	b{t
bettduch	b{tduX
bettseecheschzalot	b{tze:S@StsAlo:t
bettspree	b{tSpRe:
bevëlkere	b@v@lk@R@
bewäertungssystem	b@vE:6tuNssiste:m
bewäis	b@v{:Is
bewässere	b@v{s@R@
bewässeren	b@v{s@R@n
bewege	b@ve:z\@
bewegen	b@ve:z\@n
beweise	b@vAIz@
beweisen	b@vAIz@n
bewëllege	b@v@l@z\@
bewëllegen	b@v@l@z\@n
bewonnere	b@von@R@
bewonneren	b@von@R@n
bewonnereswäert	b@von@R@svE:6t
bewonnerung	b@von@RuN
bewosstlosegkeet	b@vostlo:z@s\ke:t
bezéiungsproblem	b@ts3IuNspRoble:m
bezuele	b@tsu@l@
bezuelen	b@tsu@l@n
bibeltext	bib@lt{kst
biber	bi:b6
bibliothecairinne	bibliote:kE:Rin@
bibliothéik	bibliot3Ik
bic	bik
bich	bis\
bichelche	bis\@ls\@
bichelchen	bis\@ls\@n
bicherbuttek	bis\6butek
bicherschaf	bis\6Sa:f
bidde	bid@
bidden	bid@n
biddo	bido:
bidet	bide:
biede	bi@d@
bieden	bi@d@n
biegerinitiativ	bie:z\6initsjAti:f
bier	bi6
bierg	bi6s\
biergaarbechterinne	bi6s\a:Rb@s\t@Rin@
bierger	bi6z\6
biergerinne	bi6z\@Rin@
biergsteigerinne	bi6s\StAIz\@Rin@
bierk	bi6k
biesem	bi@z@m
biffdeck	bifd{k
bigoudi	bigudi:
biischt	bi:St
bijou	biZu:
bijouterie	biZu:t@Ri:
bild	bilt
bildungschaos	bilduNska:os
bille	bil@
billen	bil@n
biller	bil6
billerbuch	bil6buX
billjee	bilje:
bir	bi6
birele	bi:R@l@
birelen	bi:R@l@n
bis	bis
bistro	bistRo:
bitze	bits@
bitzen	bits@n
bitzmaschinne	bitsmASin@
biz	bi:ts
bläi	bl{:I
bläistëft	bl{:ISt@ft
bläizaldot	bl{:ItsAldo:t
blaméiere	blAm3I@R@
blaméieren	blAm3I@R@n
blann	blAn
bläre	blE:R@
blären	blE:R@n
blat	bla:t
blatzeg	blAts@s\
blech	bl{s\
blechschléier	bl@s\Sl3I6
bléck	blek
bleech	ble:s\
bléi	bl3I
bléie	bl3I@
bléien	bl3I@n
bléimele	ble:im@l@
bléimelen	ble:im@l@n
bleiwe	blAIv@
bleiwen	blAIv@n
blénke	bleNk@
blénken	bleNk@n
bless	bl{s
blesséiere	bl{s3I@R@
blesséieren	bl{s3I@R@n
blesséierte	bl{s3I6t@
blesséierten	bl{s3I6t@n
blëtz	bl@ts
blëtze	bl@ts@
blëtzen	bl@ts@n
blo	blo:
block	blok
blöd	bl2:t
bloder	blo:d6
bloelzeg	blo:@lts@s\
blond	blont
blos	blo:s
blose	blo:z@
blosen	blo:z@n
blouse	blu:s
bludde	blud@
bludden	blud@n
bluddung	bluduN
blumm	blum
blummebeet	blum@be:t
blummebuttek	blum@butek
blummendëppe	blum@nd@p@
blummendëppen	blum@nd@p@n
blus	blu:s
blutt	blut
bluttaarmutt	bluda:Rmut
bluttdrock	blutdRok
bobine	bobin
bobinne	bobin@
bockel	bok@l
bockeleg	bok@l@s\
bockeleges	bok@leg@s
bocksprange	bokSpRAN@
bocksprangen	bokSpRAN@n
bokal	boka:l
boll	bol
bols	bols
boma	bo:ma:
bomen	bo:m@n
bomercher	bo:m6s\6
bomi	bo:mi
bomien	bo:mi:@n
bomm	bom
bompele	bomp@l@
bompelen	bomp@l@n
bon	bA~:
bongert	boN6t
boni	bo:ni
bonjour	bA~:Zu:6
bonsoir	bA~:swa:R
bonusse	bo:nus@
bonzele	bonts@l@
bonzelen	bonts@l@n
boot	bo:t
bopa	bo:pa:
bor	bo:R
bord	bO:R
bordüre	bORdy:R
borem	bo:R@m
bosnesch	bosn@S
bosseg	bos@s\
botanikerinne	bota:nik@Rin@
botte	bot
botter	bot6
botz	bots
botze	bots@
botzen	bots@n
botzerei	bots@RAI
botzfra	botsfRa:
bou	b@U
bouaker	b@Ua:k6
bouf	b@Uf
bougie	buZi:
boule	bul
boulette	bul{t
boun	b@Un
bouquet	buke:
bouschéisse	b@US3Is@
bouschéissen	b@US3Is@n
bouss	b@Us
boutique	butik
boutiquë	butik@
box	boks
boxe	boks@
boxen	boks@n
boxerinne	boks@Rin@
boycott	boIkot
braavst	bRa:fst
braderië	bRAdeRi:@
braderieen	bRAdeRi:@n
bräiläffel	bR{:Il{f@l
bräitchemann	bR{:Its\@mAn
brak	bRa:k
brand	bRAnt
brandwonn	bRAntvon
branntewäin	bRAnt@v{:In
brasseli	bRAs@li
bratzele	bRAts@le
bratzelen	bRAts@len
brauch	bR{:UX
brauche	bR{:UX@
brauchen	bR{:UX@n
brauereisecteur	bRAU@RAIs{kt9:R
brauereispäerd	bRAU@RAIspE:6t
braumeeschterinne	bR{:Ume:St@Rin@
braut	bR{:Ut
brautrank	bR{:UtRANk
brav	bRa:f
braven	bRa:v@n
braver	bRa:v6
bravo	bRa:vo:
bréck	bRek
breet	bRe:t
bréie	bR3I@
bréien	bR3I@n
bréif	bR3If
bréifboîte	bR3IfbwAt
bréifdréier	bR3IfdR3I6
bréifkëscht	bR3Ifk@St
bréitche	bR3Its\@
bréitchen	bR3Its\@n
brëll	bR@l
brëlle	bR@l@
brëllen	bR@l@n
brems	bR{ms
bremse	bR{mz@
bremsen	bR{mz@n
brénge	bReN@
bréngen	bReN@n
brenne	bR{n@
brennen	bR{n@n
bretelle	bR@t{l
bretonesch	bR@to:n@S
bretze	bR{ts@
bretzeg	bR{ts@s\
bretzen	bR{ts@n
brieche	bRi@s\@
briechen	bRi@s\@n
briet	bRi@t
briquet	bRike:
britt	bRit
brockelche	bRok@ls\@
brockelchen	bRok@ls\@n
brode	bRo:d@
brodéiere	bRod3I@R@
brodéieren	bRod3I@R@n
broden	bRo:d@n
bromä	bRomE:
brong	bRoN
bronkeg	bRoNk@s\
bronz	bRA~:s
brooch	bRo:X
brooche	bRo:X@
broochen	bRo:X@n
broscht	bRoSt
broschür	bRoSyR
brot	bRo:t
brout	bR@Ut
broutmaschinn	bR@UtmASin
brudder	bRud6
brüsk	bRysk
brutal	bRuta:l
brutsche	bRutS@
brutschen	bRutS@n
buch	buX
bucht	buXt
bud	bu:t
bude	bu:d@
buden	bu:d@n
budget	bydZ@:
budgetsministerinne	bu:tg@tsminist@Rin@
buedbidde	bu@tbid@
buedbidden	bu@tbid@n
buede	bu@d@
buedem	bu@d@m
bueden	bu@d@n
buedzëmmer	bu@tts@m6
buedzëmmerschaf	bu@tts@m6Sa:f
buerbes	bu6b@s
buere	bu@R@
bueren	bu@R@n
buerfouss	bu6f@Us
buerg	bu6s\
buergermeeschter	bu@z\6me:St6
buergermeeschterinne	bu6z\6me:St@Rin@
buermaschinn	bu6mASin
buermaschinne	bu6mASin@
buffet	byfe:
bull	bul
bulli	buli
bullong	buloN
bün	by:n
büneshow	by:n@S@uw
bur	bu:R
bureau	byRo:
büro	byRo:
bürokratesch	byRo:kRa:t@S
bürosklamer	byRo:skla:m6
bus	bus
busbilljee	busbilje:
buschauffer	busSo:f6
buschtaf	buSta:f
buschtawéiere	buSta:v3I@R@
buschtawéieren	buSta:v3I@R@n
buslinne	buslin@
bussar	busa:R
buttek	butek
butteker	butek6
butteksfënster	buteksf@nst6
butzeg	buts@s\
cabillaud	kAbiZo:
cabine	kAbin
cabinet	kAbine:
cabinetspabeier	kAbine:spAbAI6
cabinne	kAbin@
cadeau	kAdo:
café	kAfe:
caissier	ke:sje:
caissière	k{siE:R
calepin	kAlpE~:
camion	kAmjA~:
camionette	kAmjon{t
camionschauffer	kAmjA~:sSo:f6
campagne	kA~:mpAJ
campagnë	kA~:mpAJ@
campagnen	kA~:mpAJ@n
campéiere	k{mp3I@R@
campéieren	k{mp3I@R@n
canapé	kAnApe:
cantonnier	kAntonje:
capot	kApo:
cartouche	kARtuS
casserole	kAs@Rol
cassette	kAs{t
cauchemar	ko:Sma:R
cd	tse:de:
cendrier	sA~:dRije:
chaiselongue	SE:zlA~:g
chalumeau	SAlymo:
chamberpresidentinne	SA~:mb6pRezid{ntin@
chamberspresidentinne	SA~:mb6spRezid{ntin@
champignon	SA~:piJA~:
champion	SA~:pjA~:
chance	SA~:s
change	SA~:S
changéiere	SA~:Z3I@R@
changéieren	SA~:Z3I@R@n
chantier	SA~:tje:
chaotinne	Sa:o:tin@
charmant	SARmAnt
charme	Sa:Rm
chaudière	So:djE:R
chauffer	So:f6
chef	S{f
cheffinne	S{fin@
chemesch	Se:m@S
cheminee	Smine:
chic	Sik
chimie	Simi:
chinesesch	Sine:z@S
chips	Sips
chirurginne	s\iRuRz\in@
choix	SwA
cholerikerinne	ko:le:Rik@Rin@
cholesterol	ko:l{steRol
choufleur	Sufl9:R
chrëschtbeemche	kR@Stbe:ms\@
chrëschtbeemchen	kR@Stbe:ms\@n
chrëschtdag	kR@Stda:X
chrëschtinne	kR@Stin@
chrëschtmaart	kR@Stma:Rt
claude	klo:d@
clementine	kl@mA~:tin
client	kliA~:
clientèle	kliA~:t{l
clinique	klinik
clôture	klo:ty:R
clown	klo:n
cns	tse:{n{s
coiffer	kwAf6
col	kol
collant	kolA~:
colle	kol
commissairinne	komisE:Rin@
commissioun	komisj@Un
communiqué	komynike:
comptabel	kA~:ta:b@l
computer	kompju:t6
concert	kA~:sE:R
concierge	kA~:sjE:RS
conciergë	kA~:sjE:RZ@
conciergen	kA~:sjE:RZ@n
concours	kA~:ku:6
congé	kA~:Ze:
contraire	kA~:tRE:R
cool	ku:l
copie	kopi:
cornichon	koRniSA~:
cortège	koRtE:S
costume	kostym
côte	ko:t
coton	kotA~:
couchen	kus\@n
courage	kuRa:S
couragéiert	kuRAZ3I6t
courrier	kuRje:
cours	ku:6
course	kuRs
coursemaschinn	kuRsmASin
coursen	ku:@R@n
coursse	kuRs@
courssen	kuRs@n
cousin	kuzE~:
cousine	kuzin
coussin	kusE~:
couverte	kuvE:R@
couverten	kuvE:R@n
cravate	kRAvAt
crème	kRE:m
crevette	kR@v{t
cric	kRik
cricket	kRike:
croissant	kRwAsA~:
d	d_0
da	dA
daach	da:X
daachdeckerinne	da:Xd{k@Rin@
daarm	da:Rm
dabo	da:bo:
daccord	dAkO:R
dach	dAX
dachs	dAks
dacks	dAks
dactylo	dAktilo:
däerfe	dE:6f@
däerfen	dE:6f@n
daf	da:f
dafstomm	da:fStom
dag	da:X
dagdeeglech	da:Xde:s\l@s\
dagesausflich	da:Z@s{:Usflis\
dagesfahrt	da:Z@sfa:Rt
daierlech	dAI6l@s\
däin	d{:In
däischter	d{:ISt6
däischtert	d{:ISt6t
däitlech	d{:Itl@s\
däitlechkeet	d{:Itl@s\ke:t
däitsch	d{:ItS
däitschland	d{:ItSlAnt
däiwel	d{:Iv@l
däiwelspakt	d{:Iv@lspAkt
dall	dAl
dame	dAm
damp	dAmp
dämpe	d{mp@
dämpen	d{mp@n
dänesch	dE:n@S
dann	dAn
dännebam	d{n@ba:m
dännebësch	d{n@b@S
danz	dAnts
danze	dAnts@
danzen	dAnts@n
dänzer	d{nts6
dänzerin	d{nts@Rin
dänzerinne	d{nts@Rin@
daper	da:p6
dar	da:R
därbaants	dE:Rba:nts
däreldéier	dE:R@ld3I6
dat	da:t
datselwecht	da:tz{lv@s\t
datt	dAt
dattel	dAt@l
datum	da:tum
datz	dAts
dauche	d{:UX@
dauchen	d{:UX@n
dauer	dAU6
dauere	dAU@R@
daueren	dAU@R@n
dauf	dAUf
daum	dAUm
dausend	dAUz@nt
de	d@
débarras	de:bARa:
deboiséieren	debwAz3I@R@n
debrouilléier	debRuj3I6
débrouilléiere	debRuj3I@R@
debrouilléieren	d@bRuj3I@R@n
debutant	de:bytAnt
decalage	de:kAla:S
dech	d@s\
decharge	d@SARS
décidéiere	de:sid3I@R@
décidéieren	de:sid3I@R@n
déck	dek
decke	d{k@
deckel	d{k@l
decken	d{k@n
déckflësseg	dekfl@s@s\
déckkäppeg	dekk{p@s\
declaratioun	deklARa:tsj@Un
déclaréiere	deklAR3I@R@
déclaréieren	deklAR3I@R@n
décor	dekO:R
dee	de:
deefe	de:f@
deefen	de:f@n
deeg	de:s\
deeglaang	de:s\la:N
deeglech	de:s\l@s\
deegwuere	de:s\vu@R@
deegwueren	de:s\vu@R@n
deel	de:l
deele	de:l@
deelen	de:l@n
deelhuele	de:lhu@l@
deelhuelen	de:lhu@l@n
deelweis	de:lvAIs
deemno	de:mno:
deemools	de:mo:ls
deen	de:n
deeselwechte	de:z{lv@s\t@
deeselwechten	de:z{lv@s\t@n
déforméiere	defORm3I@R@
déforméieren	defORm3I@R@n
defouléiert	d@ful3I6t
déi	d3I
déide	d3Id@
déiden	d3Id@n
deier	dAI6
déier	d3I6
déieregaart	d3I@R@ga:Rt
déif	d3If
déift	d3Ift
déischen	d3Isj@n
déiselwecht	d3Iz{lv@s\t
delegatioun	delega:tsj@Un
delikt	delikt
dëlpessen	d@lp@s@n
delphin	d{lfi:n
delta	d{lta:
demande	d@mA~:t
demaskéier	demAsk3I6
dementi	d@m{nti:
démodéiert	demod3I6t
demographeschen	demogRa:f@S@n
demographie	demogRa:fi:
demonstrant	demonstRAnt
demonstrante	demonstRAnt@
demonstranten	demonstRAnt@n
dëmpe	d@mp@
dëmpen	d@mp@n
den	d@n
dénger	deN6
déngscht	deNSt
denke	d{Nk@
denken	d{Nk@n
denkmal	d{Nkma:l
dënn	d@n
dënschdeg	d@nSd@s\
dënschdege	d@nSd@z\@
dënschdegen	d@nSd@z\@n
dënschdes	d@nSd@s
dépanneuse	depAn2:s
départ	depa:R
depassement	d@pAs@mA~:
depassemente	d@pAs@mA~:@
depassementen	d@pAs@mA~:@n
dëppe	d@p@
dëppen	d@p@n
der	d6
derangement	d@RA~:Z@m{nt
derangementer	d@RA~:Z@m{nt6
derbäi	d6b{:I
dergéint	d6g3Int
derhannert	d6hAn6t
dermat	d6mAt
dernieft	d6ni@ft
deroutéier	deRut3I6
dervun	d6fun
derwidder	d6vid6
dës	d@s
desaffectéiert	dezAf{kt3I6t
désagréabel	dezAgRea:b@l
descente	desA~:t
dësch	d@S
dëschelduch	d@S@lduX
dëschtel	d@St@l
dëse	d@z@
dësen	d@z@n
dëslescht	d@sl{St
dessert	d@sE:R
dëst	d@st
destabiliséieren	destAbiliz3I@R@n
desto	d{sto:
detachéiers	detAS3I6s
detail	detAj
detektivinne	det{kti:vin@
developpementer	d@v@lop@m{nt6
dezember	dets{mb6
dezent	de:ts{nt
dezibel	de:tsib{l
diagnos	diAgno:s
diagnose	diAgno:z@
diagnostizéieren	dia:gnostits3I@R@n
dialog	dia:lo:X
dicher	dis\6
dicht	dis\t
dichteg	dis\t@s\
dichterinne	dis\t@Rin@
dichtung	dis\tuN
dictée	dikte:
dictéeën	dikte:@n
dictionnaire	diksjo:nE:R
die	di@
diebele	di@b@l@
diebelen	di@b@l@n
diedege	di@d@z\@
diedegen	di@d@z\@n
dien	di@n
dier	di6
dierfe	di6f@
dierfen	di6f@n
dierwiechterinne	di6vi@s\t@Rin@
dierze	di6ts@
dierzen	di6ts@n
diesel	di:z@l
diffamatoresch	difAmAto:R@S
digestiffen	diZestif@n
digitaalt	diZita:lt
digital	diZita:l
diichte	di:s\t@
diichten	di:s\t@n
diktatorinne	dikta:toRin@
dilettant	dil{tAnt
dillendapp	dil@ndAp
dinde	dE~:d
dindë	dE~:d@
dinden	dE~:d@n
diplom	diplo:m
diplomatinne	diplo:ma:tin@
dir	di6
dirängele	di:R{N@l@
dirängelen	di:R{N@l@n
direkt	diR{kt
direkter	diR{kt6
direktiounssitzung	diR{ktsj@UnsitsuN
dirigéiere	diRiZ3I@R@
dirigéieren	diRiZ3I@R@n
dirigent	diRiZ{nt
dirigentinne	diRiZ{ntin@
discipline	disiplin
disciplinéierten	disiplin3I6t@n
disco	disko:
discoursen	disku:@R@n
disponibelen	dispo:nib@l@n
disque	disk
disquë	disk@
disquen	disk@n
distanz	distAnts
distributeure	distRibut9:R@
disziplinne	distsiplin@
diwan	divA~:
diwwi	divi:
do	do:
dobäi	dob{:I
dobanne	dobAn@
dobannen	dobAn@n
dobausse	dob{:Us@
dobaussen	dob{:Us@n
dobehalen	do:b@ha:l@n
dobleiwen	do:blAIv@n
doctrinne	doktRin@
documentairen	dokymA~:ta:i:R@n
dodrun	dodRun
doe	do:@
doen	do:@n
doft	doft
dohanne	dohAn@
dohannen	dohAn@n
doheem	dohe:m
dohin	dohin
dokes	dok@s
dokessen	dok@s@n
dokter	dokt6
doktesch	dokt@S
doktrinne	doktRin@
dokumentéieren	dokum{nt3I@R@n
dokumentéiers	dokum{nt3I6s
dolch	dols\
doléiner	do:l3In6
dolmetscher	dolm{tS6
dolmetscherinne	dolm{tS@Rin@
domat	domAt
domm	dom
dommheet	domhe:t
dompeg	domp@s\
done	dA~:@
donen	dA~:@n
donieft	doni@ft
donkel	doNk@l
donner	don6
donnerwieder	don6vi@d6
donneschdeg	don@Sd@s\
donneschdes	don@Sd@s
dono	do:no:
donst	donst
doppelgänger	dop@lg{N6
dorobber	doRob6
doropshi	doRopshi
doropshin	doRopshin
dosagë	doza:Z@
dose	doz@
dosen	doz@n
dosis	do:zi:s
dot	do:t
douane	dwAn
douanier	dwAnje:
doubléieren	dubl3I@R@n
douce	du:s
doucë	du:s@
doucem	du:s@m
doucen	du:s@n
doucestem	du:s@st@m
douche	duS
doud	d@Ut
doudeg	d@Ud@s\
doudege	d@Ud@z\@
doudegen	d@Ud@z\@n
doudelued	d@Ud@lu@t
doudesannonce	d@Ud@zAnA~:s
doudmidd	d@Utmit
doudsécher	d@Utz@s\6
douéiert	du:3I6t
dous	d@Us
doutgekrasch	d@Utg@kRAS
doutgelaacht	d@Utg@la:Xt
dovun	dofun
draach	dRa:X
draguéieren	dRAg3I@R@n
dräi	dR{:I
dräieck	dR{:Iek
dräieckeg	dR{:Iek@s\
dräirad	dR{:IRa:t
dräizéng	dR{:ItseN
dram	dRa:m
dran	dRAn
dränke	dR{Nk@
dränken	dR{Nk@n
drauf	dRAUf
dréche	dR@s\@
dréchen	dR@s\@n
dréchent	dR@s\@nt
dréchne	dR@s\n@
dréchnen	dR@s\n@n
dreck	dR{k
drécke	dRek@
dreckeg	dR{k@s\
drécken	dRek@n
dréckerei	dRek@RAI
drecksak	dR{ksa:k
dreckskëscht	dR{ksk@St
dreckstipp	dR{kstip
dreeën	dRe:@n
dreeme	dRe:m@
dreemen	dRe:m@n
dréie	dR3I@
dréien	dR3I@n
dréihälsche	dR3Ih{lsj@
dréihälschen	dR3Ih{lsj@n
dréngend	dReN@nt
drénke	dReNk@
drénken	dReNk@n
drénkgeld	dReNkg{lt
drénkwaasser	dReNkva:s6
drënner	dR@n6
drëpp	dR@p
drëps	dR@ps
drëpse	dR@ps@
drëpsen	dR@ps@n
drësseg	dR@s@s\
drëtte	dR@t@
drëtten	dR@t@n
driibseg	dRi:ps@s\
driwwer	dRiv6
drobier	dRo:bi6
drock	dRok
drocksaach	dRoksa:X
droe	dRo:@
droen	dRo:@n
drog	dRo:k
drogen	dRo:g@n
drogendealerinne	dRo:g@ndi:l@Rin@
drogenhändlerinne	dRo:g@nh{ndl@Rin@
drogestatistik	dRo:g@StAtistik
drogestatistike	dRo:g@StAtistik@
drogestatistiken	dRo:g@StAtistik@n
droguéieren	dRo:g3I@R@n
droit	dRwA
droleg	dRo:l@s\
dronkenheet	dRoNk@nhe:t
drop	dRop
dropgängerinne	dRopg{N@Rin@
dropmaache	dRopma:X@
dropmaachen	dRopma:X@n
dropmouchs	dRopm@UXs
drot	dRo:t
druddele	dRud@l@
druddelen	dRud@l@n
drugéifen	dRug3If@n
drugesaten	dRug@sa:t@n
drüs	dRy:s
du	du:
dübbelen	dyb@l@n
dübel	dy:b@l
duch	duX
duché	dySe:
ducke	duk@
duckele	duk@l@
duckelen	duk@l@n
ducken	duk@n
duebel	du@b@l
duechter	du@s\t6
duer	du:6
duerch	du:6s\
duerchernee	du:6z\6ne:
duercherneen	du:6z\6ne:n
duerchfale	du:6s\fa:l@
duerchfalen	du:6s\fa:l@n
duerchfall	du:6s\fAl
duerchgéifen	du6s\g3If@n
duerchschnëttsalter	du:6s\Sn@tsAlt6
duerchsichteg	du:6s\zis\t@s\
duerchsträiche	du:6s\StR{:Is\@
duerchsträichen	du:6s\StR{:Is\@n
duerchwulle	du:6s\vul@
duerchwullen	du:6s\vul@n
duerf	du6f
duerfe	du:6f@
duerfen	du6f@n
duerfir	du6fi6
duergoe	du:6go:@
duergoen	du6go:@n
duerkomme	du:6kom@
duerkommen	du6kom@n
duerno	du6no:
dünger	dyN6
dunn	dun
dure	dy:R
dusch	duS
duschcabinne	duSkAbin@
dusche	duS@
duschen	duS@n
duschkabinne	duSkAbin@
dusel	duz@l
duuscht	du:St
duuss	du:s
duze	du:ts@
duzen	du:ts@n
dynastie	dinAsti:
e	@
ebe	e:b@
eben	e:b@n
ecart	eka:R
ecarte	eka:R@
ecarten	eka:R@n
ech	@s\
echange	@SA~:S
echangë	@SA~:Z@
echangen	@SA~:Z@n
échantillon	@SA~:tijA~:
echantillon	@SA~:tjA~:
echantillone	@SA~:tjA~:@
echantillonen	@SA~:tjA~:@n
echeance	@SeA~:s
echeancë	@SeA~:s@
echeancen	@SeA~:s@n
echec	@S{k
echecke	@S{k@
echecken	@S{k@n
echt	{s\t
eck	{k
eckeg	{k@s\
ecran	e:kRA~:
ecrane	e:kRA~:@
ecranen	e:kRA~:@n
edelstee	e:d@lSte:
edelsteen	e:d@lSte:n
educatiounsprojeten	e:duka:tsj@UnspRoZe:@n
ee	e:
eech	e:s\
eechel	e:s\@l
eed	e:t
eedem	e:d@m
eeërschuel	e:6Su@l
eeërstack	e:6StAk
eefälleg	e:f{l@s\
eefalt	e:fAlt
eege	e:z\@
eegen	e:z\@n
eegentemer	e:z\@nt@m6
eegentlech	e:z\@ntl@s\
eegentom	e:z\@ntom
eegiel	e:gi@l
eekele	e:k@l@
eekeleg	e:k@l@s\
eekelen	e:k@l@n
eekle	e:kl@
eekleg	e:kl@s\
eeklen	e:kl@n
eelef	e:l@f
eeler	e:l6
eelst	e:lst
eelste	e:lst@
eelsten	e:lst@n
eelze	e:lts@
eelzen	e:lts@n
eemer	e:m6
eemol	e:mo:l
een	e:n
eenege	e:n@z\@
eenegen	e:n@z\@n
eent	e:nt
eenzeg	e:nts@s\
eenzege	e:nts@z\@
eenzegen	e:nts@z\@n
eenzegt	e:nts@s\t
eenzel	e:nts@l
eenzelheete	e:nts@lhe:t@
eenzelheeten	e:nts@lhe:t@n
eenzock	e:ntsok
eescht	e:St
eeschtlech	e:Stl@s\
eess	e:s
eeter	e:t6
eewäiss	e:v{:Is
efeu	e:foI
effete	{fe:@
effeten	{fe:@n
efficacen	{fikAs@n
efficacer	{fikAs6
efficacest	{fikAs@st
efficacet	{fikAst
effiziente	{fitsj{nt
effizienter	{fitsj{nt6
effort	{fO:R
efforte	{fO:R@
efforten	{fO:R@n
egal	ega:l
égout	egu:
eidechs	AId{ks
eidel	AId@l
éier	3I6
éierbar	3I6ba:R
éierewou	3I@R@w@U
éiergäiz	3I6g{:Its
éiergäizeg	3I6g{:Its@s\
éierlech	3I6l@s\
eigentlech	AIz\@ntl@s\
eil	AIl
éil	3Il
einfach	AInfAX
einsamkeet	AInza:mke:t
eintlech	AIntl@s\
eis	AIs
éischt	3ISt
éischte	3ISt@
éischten	3ISt@n
éischter	3ISt6
eise	AIz@
eisebunn	AIzebun
eisebunner	AIzebun6
eisekuch	AIzekuX
eisen	AIz@n
eisepäertche	AIz@pE:6ts\@
eisepäertchen	AIz@pE:6ts\@n
eiser	AIz6
éislek	3Islek
eist	AIst
éiweg	3Iv@s\
éiwegkeet	3Iv@s\ke:t
ekel	e:k@l
ekologistinne	e:ko:logistin@
ekonomistinne	e:ko:no:mistin@
elaboréieren	elAboR3I@R@n
elauter	@l{:Ut6
elch	{ls\
elefeant	@l@fAnt
elei	@lAI
elektriker	el{ktRik6
elementar	@l@m{nta:R
elementarem	@l@m{nta:R@m
elementer	@l@m{nt6
eleng	@l{N
elitär	elitE:R
elitären	elitE:R@n
elle	{l@
ellen	{l@n
elo	@lo:
eltere	{lt@R@
elteren	{lt@R@n
ëm	@m
emäermele	@mE:6m@l@
emäermelen	@mE:6m@l@n
email	emAj
émail	emAj
emailléier	emAj3I6
ëmännere	@m{n@R@
ëmänneren	@m{n@R@n
emballage	A~:mbAla:S
emballagë	A~:mbAlAZ@
emballagen	A~:mbAla:Z@n
embargo	{mbARgo:
ëmbloost	@mblo:st
embolie	A~:mboli:
ëmbrénge	@mbReN@
ëmbréngen	@mbReN@n
embryo	{mbRio:
embryoe	{mbRio:@
ëmdréie	@mdR3I@
ëmdréien	@mdR3I@n
ëmfang	@mfAN
emfank	@mfANk
emfänke	@mf{Nk@
emfänken	@mf{Nk@n
emfindlech	@mfindl@s\
ëmfro	@mfRo:
emgéigend	@mg3Iz\@nt
ëmgeréits	@mg@R3Its
ëmkomme	@mkom@
ëmkommen	@mkom@n
ëmleede	@mle:d@
ëmleeden	@mle:d@n
ëmmer	@m6
emol	@mo:l
emotionaler	emotsjo:na:l6
emotioun	emotj@Un
ëmpeg	@mp@s\
empfaangen	{mpfa:N@n
empfang	{mpfAN
empfindlech	{mpfindl@s\
employé	A~:plwAje:
emsoss	@mzos
ëmstand	@mStAnt
ëmstousse	@mSt@Us@
ëmstoussen	@mSt@Us@n
ëmwee	@mwe:
en	@n
enceinte	A~:sE~:t
endege	{nd@z\@
endegen	{nd@z\@n
endlech	{ndl@s\
energie	enERZi:
eng	{N
engagéiere	A~:ga:Z3I@R@
engagéieren	A~:ga:Z3I@R@n
engel	{N@l
engem	{N@m
england	{NlAnt
englänner	{Nl{n6
englännerin	{Nl{n@Rin
englesch	{Nl@S
enk	{Nk
enkel	{Nk@l
enkelkand	{Nk@lkAnt
enn	{n
ënn	@n
ënne	@n@
ënnen	@n@n
ënnenan	@n@nAn
ënner	@n6
ënnerbrieche	@n6bRi@s\@
ënnerbriechen	@n6bRi@s\@n
ënnerdaach	@n6da:X
ënnergehëlz	@n6g@h@lts
ënnergoe	@n6go:@
ënnergoen	@n6go:@n
ënnerhale	@n6ha:l@
ënnerhalen	@n6ha:l@n
ënnerhuele	@n6hu@l@
ënnerhuelen	@n6hu@l@n
ënnerläif	@n6l{:If
ënnerriichte	@n6Ri:s\t@
ënnerriichten	@n6Ri:s\t@n
ënnerscheed	@n6Se:t
ënnerscheede	@n6Se:d@
ënnerscheeden	@n6Se:d@n
ënnerschrëft	@n6SR@ft
ënnerschreiwe	@n6SRAIv@
ënnerschreiwen	@n6SRAIv@n
ënnersiche	@n6zis\@
ënnersichen	@n6zis\@n
ënnerstëtzung	@n6St@tsuN
ënnersträiche	@n6StR{:Is\@
ënnersträichen	@n6StR{:Is\@n
ënnert	@n6t
ënnertenaner	@n6t@na:n6
ënnerwäsch	@n6v{S
ënnerwee	@n6ve:
ënnerwierfeg	@n6vi@f@s\
enniichter	@ni:s\t6
enorm	enORm
entdecke	@ntd{k@
entdecken	@ntd{k@n
entdeeën	@ntde:@n
entfale	@ntfa:l@
entfalen	@ntfa:l@n
enthale	@ntha:l@
enthalen	@ntha:l@n
entnäipe	@ntn{:Ip@
entnäipen	@ntn{:Ip@n
entpuppe	@ntpup@
entpuppen	@ntpup@n
entrée	A~:tRe:
entrepreneur	A~:tR@pR@n6
entrevue	A~:tR@vy:
entscheede	@ntSe:d@
entscheeden	@ntSe:d@n
entschëllege	@ntS@l@z\@
entschëllegen	@ntS@l@z\@n
entschiedege	@ntSi@d@z\@
entschiedegen	@ntSi@d@z\@n
entschlofe	@ntSlo:f@
entschlofen	@ntSlo:f@n
entwéckele	@ntvek@l@
entwéckelen	@ntvek@l@n
entwerfe	@ntvERf@
entwerfen	@ntvERf@n
entworf	@ntvORf
entwutsche	@ntvutS@
entwutschen	@ntvutS@n
entziffere	@nttsif@R@
entzifferen	@nttsif@R@n
enveloppe	A~:v@lop
épicerie	epis@Ri:
épicier	episje:
epidemien	epide:mi:@n
epilatioun	epila:tsj@Un
epilatioune	epila:tsj@Un@
epilatiounen	epila:tsj@Un@n
epiléier	epil3I6
epilepsie	epile:psi:
epileptesch	epil{pt@S
eponge	epA~:S
epongen	epA~:Z@n
eppes	{p@s
équipe	ekip
equivalenz	e:ki:va:l{nts
eragoe	@RAgo:@
eragoen	@RAgo:@n
eraklappbar	@RAklApba:R
erakomme	@RAkom@
erakommen	@RAkom@n
eran	@RAn
eraus	@R{:Us
erausfanne	@R{:UsfAn@
erausfannen	@R{:UsfAn@n
erausgoe	@R{:Usgo:@
erausgoen	@R{:Usgo:@n
eraushuele	@R{:Ushu@l@
eraushuelen	@R{:Ushu@l@n
erausklamme	@R{:UsklAm@
erausklammen	@R{:UsklAm@n
erauskomme	@R{:Uskom@
erauskommen	@R{:Uskom@n
erausrappe	@R{:UsRAp@
erausrappen	@R{:UsRAp@n
erausschëdde	@R{:UsS@d@
erausschëdden	@R{:UsS@d@n
eraussiche	@R{:Uszis\@
eraussichen	@R{:Uszis\@n
erbäilafe	6b{:Ila:f@
erbäilafen	6b{:Ila:f@n
erbléckse	6bleks@
erblécksen	6bleks@n
erblose	6blo:z@
erblosen	6blo:z@n
erbrieche	6bRi@s\@
erbriechen	6bRi@s\@n
erdiischtere	6di:St@R@
erdiischteren	6di:St@R@n
erdrag	6dRa:X
erdrénke	6dReNk@
erdrénken	6dReNk@n
erdroe	6dRo:@
erdroen	6dRo:@n
eréischt	@R3ISt
erëm	@R@m
erëmbrénge	@R@mbReN@
erëmbréngen	@R@mbReN@n
erëmfanne	@R@mfAn@
erëmfannen	@R@mfAn@n
erëmgesi	@R@mg@zi
erëmgesinn	@R@mg@zin
erëmgi	@R@mgi
erëmginn	@R@mgin
erëmkenne	@R@mk{n@
erëmkennen	@R@mk{n@n
erëmkomme	@R@mkom@
erëmkommen	@R@mkom@n
erëmkréie	@R@mkR3I@
erëmkréien	@R@mkR3I@n
erënnere	6@n@R@
erënneren	6@n@R@n
erënnerung	6@n@RuN
erfanne	6fAn@
erfannen	6fAn@n
erféiere	6f3I@R@
erféieren	6f3I@R@n
erfolleg	6fol@s\
erfréiere	6fR3I@R@
erfréieren	6fR3I@R@n
erhéiung	6h3IuN
erhéngere	6heN@R@
erhéngeren	6heN@R@n
erhuelung	6hu@luN
eriwwer	@Riv6
eriwwergoe	@Riv6go:@
eriwwergoen	@Riv6go:@n
erkale	6ka:l@
erkalen	6ka:l@n
erkältung	6k{ltuN
erkenne	6k{n@
erkennen	6k{n@n
erkläre	6klE:R@
erklären	6klE:R@n
erlaabnes	6la:bn@s
erlaabs	6la:ps
erlabe	6la:b@
erlaben	6la:b@n
erleedege	6le:d@z\@
erleedegen	6le:d@z\@n
erléise	6l3Iz@
erléisen	6l3Iz@n
erliewe	6li@v@
erliewen	6li@v@n
erliichtere	6li:s\t@R@
erliichteren	6li:s\t@R@n
ermiddend	6mid@nt
erneiere	6nAI@R@
erneieren	6nAI@R@n
erniere	6ni@R@
ernieren	6ni@R@n
ernimme	6nim@
ernimmen	6nim@n
erof	@Ro:f
erofdroe	@Ro:fdRo:@
erofdroen	@Ro:fdRo:@n
eroffale	@Ro:ffa:l@
eroffalen	@Ro:ffa:l@n
erofgoe	@Ro:fgo:@
erofgoen	@Ro:fgo:@n
erofloosse	@Ro:flo:s@
erofloossen	@Ro:flo:s@n
erofmaache	@Ro:fma:X@
erofmaachen	@Ro:fma:X@n
erofrappe	@Ro:fRAp@
erofrappen	@Ro:fRAp@n
erop	@Rop
eropdroe	@RopdRo:@
eropdroen	@RopdRo:@n
eropgoe	@Ropgo:@
eropgoen	@Ropgo:@n
eropklamme	@RopklAm@
eropklammen	@RopklAm@n
eropkomme	@Ropkom@
eropkommen	@Ropkom@n
erreeche	6Re:s\@
erreechen	6Re:s\@n
erreger	6Re:z\6
ersatzstéck	6zAtsStek
ersaufe	6z{:Uf@
ersaufen	6z{:Uf@n
erschénge	6SeN@
erschéngen	6SeN@n
ersetze	6s{ts@
ersetzen	6s{ts@n
erstécke	6Stek@
erstécken	6Stek@n
eruewere	6u@veR@
erueweren	6u@veR@n
eruewerung	6u@v@RuN
ervirdoe	6fi6do:@
ervirdoen	6fi6do:@n
ervirhiewe	6fi6hi@v@
ervirhiewen	6fi6hi@v@n
erwaarde	6va:Rd@
erwaarden	6va:Rd@n
erwaardung	6va:RduN
erwäche	6v{s\@
erwächen	6v{s\@n
erwësche	6v@S@
erwëschen	6v@S@n
erwierge	6vi@z\@
erwiergen	6vi@z\@n
erwuess	6vu@s
erwuessene	6vu@s@n@
erwuessenen	6vu@s@n@n
erzéie	6ts3I@
erzéien	6ts3I@n
erzéiung	6ts3IuN
erziele	6tsi@l@
erzielen	6tsi@l@n
erzielung	6tsi@luN
esch	{S
esou	@z@U
esoubal	@z@Uba:l
esouguer	@z@Ugu6
esseg	{s@s\
et	@t
etgen	@tz\@n
etikett	etik{t
etlech	{tl@s\
etlechmol	{tl@s\mo:l
etüd	e:ty:t
europa	oIRo:pa:
europäesch	oIRo:pE:@S
ewechbrénge	@v@s\bReN@
ewechbréngen	@v@s\bReN@n
ewechgi	@v@s\gi
ewechginn	@v@s\gin
ewechhuele	@v@s\hu@l@
ewechhuelen	@v@s\hu@l@n
ewell	@v{l
exame	{gza:m@
examen	{gza:m@n
exercice	{gz6sis
experienz	{kspE:Rj{nts
expertise	{kspE:Rti:s
export	{kspORt
expositioun	{kspozitsj@Un
express	{kspR{s
extere	{kst{R@
exteren	{kst{R@n
exzellent	{ks{l{nt
faarf	fa:Rf
faarfdëppe	fa:Rfd@p@
faarfdëppen	fa:Rfd@p@n
faarweg	fa:Rv@s\
faaschte	fa:St@
faaschten	fa:St@n
faass	fa:s
fabréck	fAbRek
fabrizéiere	fAbRits3I@R@
fabrizéieren	fAbRits3I@R@n
facteur	fAkt9:R
fad	fa:t
fäeg	fE:@s\
fäert	fE:6t
fäerte	fE:6t@
fäerten	fE:6t@n
fal	fa:l
fale	fa:l@
falen	fa:l@n
fall	fAl
fallschierm	fAlSi6m
FALSCH	fAlS
fälsche	f{lS@
fälschen	f{lS@n
faméis	fAm3Is
familiär	fAmiljE:R
famill	fAmil
familljennumm	fAmilj@num
fändel	f{nd@l
fanger	fAN6
fänke	f{Nk@
fänken	f{Nk@n
fanne	fAn@
fannen	fAn@n
fantastesch	fAntAst@S
far	fa:R
fasan	fAza:n
fassad	fAsa:t
fatz	fAts
fatzeg	fAts@s\
faubourg	fo:bu:6
faul	fAUl
faule	fAUl@
faulen	fAUl@n
faulenze	f{:Ul{nts@
faulenzen	f{:Ul{nts@n
fauscht	f{:USt
favoriséiere	fAvoRis3I@R@
favoriséieren	fAvoRis3I@R@n
fax	fAks
februar	fe:bRua:R
fechte	f{s\t@
fechten	f{s\t@n
feele	fe:l@
feelen	fe:l@n
feeler	fe:l6
feescht	fe:St
feier	fAI6
feierblumm	fAI6blum
feiere	fAI@R@
féiere	f3I@R@
feieren	fAI@R@n
féieren	f3I@R@n
feierkuerf	fAI6ku6f
feierlech	fAI6l@s\
feierrout	fAI6R@Ut
feig	fAIs\
feigheet	fAIs\he:t
feigling	fAIs\liN
feil	fAIl
feile	fAIl@
feilen	fAIl@n
feind	fAInt
féiwer	f3Iv6
féiwereg	f3Iv@R@s\
feld	f{lt
feldhong	f{lthoN
feldwee	f{ltwe:
felg	f{ls\
félicitatioun	felisita:tsj@Un
félicitéiere	felisit3I@R@
félicitéieren	felisit3I@R@n
fëlle	f@l@
fëllen	f@l@n
fëmme	f@m@
fëmmen	f@m@n
fëmmert	f@m6t
fénkele	feNk@l@
fénkelen	feNk@l@n
fënnef	f@n@f
fënnefte	f@n@ft@
fënneften	f@n@ft@n
fënster	f@nst6
fernand	fERnA~:
fernseh	fERnze:
fësch	f@S
fësche	f@S@
fëschen	f@S@n
fëscher	f@S6
fëscherboot	f@S6bo:t
fëschfänke	f@Sf{Nk@
fëschfänken	f@Sf{Nk@n
fëschmaart	f@Sma:Rt
fëschrutt	f@SRut
fest	f{st
festmaache	f{stma:X@
festmaachen	f{stma:X@n
feststelle	f{stSt{l@
feststellen	f{stSt{l@n
festung	f{stuN
fett	f{t
fetteg	f{t@s\
ficelle	fis{l
fiddere	fid@R@
fidderen	fid@R@n
fieder	fi@d6
fiederball	fi@d6bAl
fiels	fi@ls
fierchterlech	fi@s\t6l@s\
fierkel	fi6k@l
fierschter	fi@St6
fierwe	fi6v@
fierwen	fi6v@n
fiffeg	fif@s\
fiffi	fifi:
fig	fi:k
figur	figu:R
fiicht	fi:s\t
fiissche	fi:sj@
fiisschen	fi:sj@n
filet	file:
filial	filja:l
fille	fil@
fillen	fil@n
film	film
fils	fis
filter	filt6
filtere	filt@R@
filteren	filt@R@n
filz	filts
finale	finAl
finall	finAl
firma	fiRma:
firmung	fiRmuN
firwat	fi6va:t
fischi	fiSi:
fisele	fiz@l@
fiselen	fiz@l@n
fiselree	fiz@lRe:
fiselreen	fiz@lRe:n
fixfeier	fiksfAI6
fixspoun	fiksSp@Un
fize	fi:ts@
fizen	fi:ts@n
flaach	fla:X
flackere	flAk@R@
flackeren	flAk@R@n
fläiss	fl{:Is
fläisse	fl{:Is@
fläisseg	fl{:Is@s\
fläissen	fl{:Is@n
flam	fla:m
flame	fla:m@
flamen	fla:m@n
flämesch	flE:m@S
flantermaus	flAnt6ma:us
flantesseg	flAnt@s@s\
fläsch	fl{S
fläschelche	fl{S@ls\@
fläschelchen	fl{S@ls\@n
flätsch	fl{tS
flauscheg	fl{:US@s\
fleck	fl{k
flécke	flek@
flécken	flek@n
fleege	fle:z\@
fleegen	fle:z\@n
fleesch	fle:S
fleeschwollef	fle:Swol@f
fleete	fle:t@
fleeten	fle:t@n
fléie	fl3I@
fléien	fl3I@n
flemm	fl{m
flemmseg	fl{ms@s\
flénk	fleNk
flënt	fl@nt
flësseg	fl@s@s\
flicht	flis\t
fliger	fli:z\6
flillek	flilek
flom	flo:m
floss	flos
flott	flot
flou	fl@U
floumaart	fl@Uma:Rt
flu	flu:
fluch	fluX
fluche	fluX@
fluchen	fluX@n
fluchhafen	flu:Xha:f@n
flughafe	flu:Xha:f@
flughafen	flu:Xha:f@n
flüstere	flyst@R@
flüsteren	flyst@R@n
flütt	flyt
fochs	foks
focke	fok@
focken	fok@n
fofzeg	fofts@s\
fofzéng	foftseN
föhn	f2:n
foire	fwa:R
folleche	fol@s\@
follechen	fol@s\@n
folter	folt6
fonctionnéiere	foNksjo:n3I@R@
fonctionnéieren	foNksjo:n3I@R@n
fonke	foNk@
fonkelnei	foNk@lnAI
fonken	foNk@n
foosche	fo:S@
fooschen	fo:S@n
football	futbAl
footing	fu:tiN
forell	foR{l
form	fORm
forme	fORm@
formen	fORm@n
forschette	fORS{t
fort	fORt
fortfléie	fORtfl3I@
fortfléien	fORtfl3I@n
fortgoe	fORtgo:@
fortgoen	fORtgo:@n
fortlafe	fORtla:f@
fortlafen	fORtla:f@n
fortschécke	fORtSek@
fortschécken	fORtSek@n
fotell	fo:t{l
foto	foto:
fotoapparat	foto:ApARa:t
fotograf	foto:gRa:f
fouer	f@U6
foulard	fula:R
fouss	f@Us
foussball	f@UsbAl
foussgänger	f@Usg{N6
foussgängerzon	f@Usg{N6tso:n
foussteppech	f@Ust{p@s\
fra	fRa:
fracht	fRAXt
frachtschëff	fRAXtS@f
fräi	fR{:I
fräie	fR{:I@
fräien	fR{:I@n
fräiheet	fR{:Ihe:t
fräiwëlleg	fR{:Iv@l@s\
fräizäit	fR{:Its{:It
françois	fRA~:swA
françoise	fRA~:swAs
frang	fRAN
frankräich	fRANkR{:Is\
franséisch	fRAnz3IS
fransous	fRAnz@Us
fräsch	fR{S
fräschmann	fR{SmAn
frascht	fRASt
fraschtknupp	fRAStknup
frech	fR{s\
freed	fRe:t
freedefeier	fRe:d@fAI6
fréi	fR3I
freideg	fRAId@s\
freides	fRAId@s
freie	fRAI@
freien	fRAI@n
freier	fRAI6
fréier	fR3I6
fréiere	fR3I@R@
fréieren	fR3I@R@n
freiesch	fRAI@S
fréijor	fR3Ijo:R
frell	fR{l
frënd	fR@nt
frëndin	fR@ndin
frëndlech	fR@ndl@s\
frëndschaft	fR@ntSAft
frëndschaftlech	fR@ntSAftl@s\
frësch	fR@S
frettche	fR{ts\@
frettchen	fR{ts\@n
fridde	fRid@
fridden	fRid@n
friddlech	fRidl@s\
friem	fRi@m
frieme	fRi@m@
friemen	fRi@m@n
friesse	fRi@s@
friessen	fRi@s@n
frigidaire	fRiZidE:R
frigo	fRigo:
fritt	fRit
frittebud	fRit@bu:t
fro	fRo:
froe	fRo:@
froen	fRo:@n
fromm	fRom
fronze	fRonts@
fronzen	fRonts@n
frou	fR@U
fruchtbar	fRuXtba:R
fruucht	fRu:Xt
fuddele	fud@l@
fuddelen	fud@l@n
fudder	fud6
fuebele	fu@b@l@
fuebelen	fu@b@l@n
fuedem	fu@d@m
fuendel	fu@nd@l
fuerchtbar	fu6s\tba:R
fuerdere	fu@d@R@
fuerderen	fu@d@R@n
fuere	fu@R@
fueren	fu@R@n
fuerf	fu6f
fuersche	fu6S@
fuerschen	fu6S@n
fuerweg	fu6v@s\
fuesbal	fu@sba:l
fuesent	fu@s@nt
fueskostüm	fu@skostym
führerschäin	fy:R6S{:In
füllfieder	fylfi@d6
fummele	fum@l@
fummelen	fum@l@n
fusche	fuS@
fuschen	fuS@n
futti	futi
futur	fyty:R
füügt	fy:s\t
fuuss	fu:s
fuusseg	fu:s@s\
gaangs	ga:Ns
gaapse	ga:ps@
gaapsen	ga:ps@n
gaardeboun	ga:Rd@b@Un
gaardenhaische	ga:Rd@nhAIsj@
gaardenhaischen	ga:Rd@nhAIsj@n
gaart	ga:Rt
gaascht	ga:St
gaaschtfrëndlech	ga:StfR@ndl@s\
gaass	ga:s
gäertner	gE:6tn6
gaffe	gAf
gäissel	g{:Is@l
gäizeg	g{:Its@s\
gäizhals	g{:ItshAls
gakeg	ga:k@s\
gal	ga:l
gangster	g{Nst6
gank	gANk
gäns	g{ns
ganz	gAnts
gär	gE:R
garage	gARa:S
garagë	gARa:Z@
garagen	gARa:Z@n
garantéiere	gARA~:nt3I@R@
garantéieren	gARA~:nt3I@R@n
garçon	gARsA~:
gare	ga:R
gas	ga:s
gaston	gAstA~:
gebai	g@bAI
gebaier	g@bAI6
gebastels	g@bAst@ls
gebéck	g@bek
gebeess	g@be:s
gebeessglas	g@be:sgla:s
gebëss	g@b@s
gebiet	g@bi@t
gebills	g@bils
gebilt	g@bilt
gebimmels	g@bim@ls
gebitt	g@bit
gebläers	g@blE:6s
gebraddels	g@bRAd@ls
gebräicher	g@bR{:Is\6
gebräicherlech	g@bR{:Is\6l@s\
gebrauch	g@bR{:UX
gebrode	g@bRo:d@
gebroden	g@bRo:d@n
gebuert	g@bu6t
gebuertsdag	g@bu6tsda:X
gebuertsdagskaart	g@bu6tsda:Xska:Rt
gebuertsdagskuch	g@bu6tsda:XskuX
geck	g{k
geckeg	g{k@s\
geckegkeet	g{k@s\ke:t
geckenhaus	g{k@nh{:Us
geckse	g{ks@
gecksen	g{ks@n
gedeessems	g@de:s@ms
gedéiesch	g@d3I@S
gedëlleg	g@d@l@s\
gedicht	g@dis\t
gedold	g@dolt
gedrécks	g@dReks
gedrénks	g@dReNks
gëeegent	g@e:z\@nt
geescht	ge:St
geeschterbunn	ge:St6bun
geess	ge:s
gefaangene	g@fa:N@n@
gefaangenen	g@fa:N@n@n
gefale	g@fa:l@
gefalen	g@fa:l@n
gefälleg	g@f{l@s\
gefecht	g@f{s\t
geféierlech	g@f3I6l@s\
gefill	g@fil
gefor	g@fo:R
gëft	g@ft
gëfteg	g@ft@s\
gehacktes	g@hAkt@s
gehässeg	g@h{s@s\
geheie	g@hAI@
geheien	g@hAI@n
gehéier	g@h3I6
gehéiere	g@h3I@R@
gehéieren	g@h3I@R@n
geheim	g@hAIm
geheimnes	g@hAImn@s
gehir	g@hi6
gei	gAI
géi	g3I
geier	gAI6
geiereg	gAI@R@s\
géigend	g3Iz\@nt
géigendeel	g3Iz\@nde:l
géigner	g3Iz\n6
géint	g3Int
géintiwwer	g3Indiv6
geisel	gAIz@l
gejäiz	g@z\{:Its
gejirimiris	g@z\iRimiRis
gekréngelt	g@kReN@lt
gelänner	g@l{n6
geld	g{lt
geleeënheet	g@le:@nhe:t
geléierte	g@l3I6t@
geléierten	g@l3I6t@n
gelldir	g{ldi6
gëlle	g@l@
gëllen	g@l@n
gelunge	g@luN@
gelungen	g@luN@n
geméis	g@m3Is
gemeng	g@m{N
gemittlech	g@mitl@s\
genéck	g@nek
genee	g@ne:
genéiere	Z@n3I@R@
genéieren	Z@n3I@R@n
genéisse	g@n3Is@
genéissen	g@n3Is@n
generique	Ze:neRik
genn	g{n
genoss	g@nos
gënschteg	g@nSt@s\
genuch	g@nuX
genug	g@nuX
geographie	Ze:ogRAfi:
geometer	Ze:ome:t6
gepäck	g@p{k
gérant	Ze:RA~:
gerechterweis	g@R{s\t6wAIs
géréiere	Ze:R3I@R@
géréieren	Ze:R3I@R@n
gerënne	g@R@n@
gerënnen	g@R@n@n
geriicht	g@Ri:s\t
geroch	g@RoX
gerode	g@Ro:d@
geroden	g@Ro:d@n
gerücht	g@Rys\t
geschäft	g@S{ft
geschäftlech	g@S{ftl@s\
geschäftsfra	g@S{ftsfRa:
geschäftsmann	g@S{ftsmAn
geschéckerlech	g@Sek6l@s\
gescheet	g@Se:t
geschéie	g@S3I@
geschéien	g@S3I@n
gescheit	g@SAIt
gescheitheet	g@SAIthe:t
geschicht	g@Sis\t
geschir	g@Si6
geschmaach	g@Sma:X
gëschter	g@St6
geschützt	g@Sytst
geschwätz	g@Sw{ts
geschwë	g@Sw@
geschwënn	g@Sw@n
gesellschaft	g@s{lSAft
gesetz	g@z{ts
gesi	g@zi
gesiicht	g@zi:s\t
gesinn	g@zin
gesond	g@zont
gesondheet	g@zonthe:t
gespaart	g@Spa:Rt
gespär	g@SpE:R
gespenst	g@Sp{nst
gespréich	g@SpR3Is\
gespréicheg	g@SpR3Is\@s\
gest	Z{st
geständnes	g@St{ntn@s
gestank	g@StANk
geste	Z{st
gestë	Z{st@
gestell	g@St{l
gesträift	g@StR{:Ift
gestrëpp	g@StR@p
getëppelt	g@t@p@lt
gette	g{t@
getten	g{t@n
gewalt	g@vAlt
gewan	g@va:n
gewanne	g@vAn@
gewannen	g@vAn@n
gewei	g@vAI
gewéinlech	g@v3Inl@s\
gewësse	g@v@s@
gewëssen	g@v@s@n
gewëssenhaft	g@v@s@nhAft
gewëssheet	g@v@she:t
gewier	g@vi6
gewierweg	g@vi6v@s\
gewierwegkeet	g@vi6v@s\ke:t
gewierz	g@vi6ts
gewiicht	g@vi:s\t
gewulls	g@vuls
gewunnecht	g@vun@s\t
gezei	g@tsAI
gi	gi
gidd	git
giedel	gi@d@l
giedlech	gi@dl@s\
giel	gi@l
gielzecht	gi@lts@s\t
gielzeg	gi@lts@s\
gierkse	gi6ks@
gierksen	gi6ks@n
giewel	gi@v@l
gilet	Zile:
ginn	gin
gips	gips
gipser	gips6
giraff	ZiRAf
girland	giRlAnt
giss	gis
gitar	gita:R
glace	glAs
glach	glAX
gläich	gl{:Is\
glas	gla:s
glaspabeier	gla:spAbAI6
glat	gla:t
glatz	glAts
glawen	gla:v@n
gléck	glek
glécke	glek@
glécken	glek@n
glécklech	glekl@s\
gléckwonsch	glekvonS
gleewe	gle:v@
gleeweg	gle:v@s\
gleewen	gle:v@n
gleis	glAIs
glënnere	gl@n6@
glënneren	gl@n6@n
glëtsche	gl@tS@
glëtscheg	gl@tS@s\
glëtschen	gl@tS@n
glidd	glit
gliddeg	glid@s\
globus	glo:bus
glous	gl@Us
goe	go:@
goen	go:@n
gold	golt
goldfësch	goltf@S
golf	golf
gomm	gom
gonscht	gonSt
gorilla	goRila:
gott	got
gottseidank	gotsAIdANk
goudron	gudRA~:
goungen	g@UN@n
goungs	g@UNs
goungt	g@UNt
goureg	g@UR@s\
goût	gu:
grad	gRa:t
graf	gRa:f
graff	gRAf
gräife	gR{:If@
gräifen	gR{:If@n
gräisslech	gR{:Isl@s\
gramm	gRAm
grand	gRA~:
granzeg	gRAnts@s\
grapp	gRAp
gras	gRa:s
gratis	gRa:tis
gratuléiere	gRAtul3I@R@
gratuléieren	gRAtul3I@R@n
grausam	gRAUsa:m
gravéiere	gRAv3I@R@
gravéieren	gRAv3I@R@n
greef	gRe:f
greeze	gRe:ts@
greezen	gRe:ts@n
grëff	gR@f
gréisst	gR3Ist
grell	gR{l
grëndlech	gR@ndl@s\
gréng	gReN
gréngelzeg	gReN@lts@s\
grënne	gR@n@
grënnen	gR@n@n
grenz	gR{nts
griichesch	gRi:s\@S
grille	gRil@
grillen	gRil@n
grimass	gRimAs
grimmel	gRim@l
grinse	gRinz@
grinsen	gRinz@n
gripp	gRip
gro	gRo:
groelzeg	gRo:@lts@s\
grog	gRok
grommele	gRom@l@
grommelen	gRom@l@n
gromper	gRomp6
gromperenzalot	gRomp@R@ntsAlo:t
gromperepurée	gRomp@R@py:Re:
grond	gRont
grondwaasser	gRontva:s6
gronn	gRon
grossist	gRosist
grott	gRot
groupe	gRup
grouss	gR@Us
groussaarteg	gR@Uza:Rt@s\
grousseltere	gR@Uz{lt@R@
grousselteren	gR@Uz{lt@R@n
groussgaass	gR@Usga:s
groussherzog	gR@UshERtso:X
groussherzogin	gR@UshERtso:gin
groussjäreg	gR@UsjE:R@s\
grued	gRu@t
gruef	gRu@f
gruewe	gRu@v@
gruewen	gRu@v@n
grujeleg	gRuZ@l@s\
grupp	gRup
gruppéiere	gRup3I@R@
gruppéieren	gRup3I@R@n
guckucksblumm	gukuksblum
gued	gu@t
guergel	gu@z\@l
guert	gu6t
guichet	giSe:
guidë	gi:d@
guide	gi:t
guiden	gi:d@n
gumm	gum
gummi	gumi
güterzuch	gy:t6tsuX
gutt	gut
guttaarteg	guda:Rt@s\
guttheesche	guthe:S@
guttheeschen	guthe:S@n
guttheet	guthe:t
haapt	ha:pt
haaptsaach	ha:ptsa:X
haaptsächlech	ha:pts{s\l@s\
haaptstad	ha:ptSta:t
haart	ha:Rt
haarz	ha:Rts
haascht	ha:St
haass	ha:s
haasse	ha:s@
haassen	ha:s@n
hae	ha:@
haen	ha:@n
häerz	hE:6ts
häerzche	hE:6tsj@
häerzchen	hE:6tsj@n
häerzeg	hE:6ts@s\
häerzi	hE:6tsi:
häerzkrank	hE:6tskRANk
hafe	ha:f@
hafen	ha:f@n
haff	hAf
haifësch	hAIf@S
häip	h{:Ip
haische	hAIsj@
haischen	hAIsj@n
hale	ha:l@
halen	ha:l@n
häll	h{l
hall	hO:l
hallef	hAl@f
hallefnuecht	hAl@fnu@s\t
hallefstonn	hAl@fSton
hallem	hAl@m
hällewull	h{l@vul
hals	hAls
halschent	hAlS@nt
halswéi	hAlsv3I
halt	hAlt
halwe	hAlv@
halwen	hAlv@n
halwer	hAlv6
ham	ha:m
hambier	hAmbi6
hamburger	hAmbuRg6
hämmche	h{ms\@
hämmchen	h{ms\@n
hammel	hAm@l
hämmelfleesch	h{m@lfle:S
hampelmann	hAmp@lmAn
hamster	hAmst6
hamstere	hAmst@R@
hamsteren	hAmst@R@n
hand	hAnt
handduch	hAntduX
handele	hAnd@l@
handelen	hAnd@l@n
handgelenk	hAntg@l{Nk
händler	h{ndl6
händsch	h{ntS
handschelle	hAntS{l@
handschellen	hAntS{l@n
handwierker	hAntvi6k6
handwierksgeschir	hAntvi6ksg@Si6
hänk	h{Nk
hänke	h{Nk@
hänken	h{Nk@n
hanne	hAn@
hannelaanscht	hAn@la:nSt
hannen	hAn@n
hannendrun	hAn@ndRun
hannergrond	hAn6gRont
hannert	hAn6t
hannerwands	hAn6vAnts
hannerwenneg	hAn6v{n@s\
hannerzeg	hAn6ts@s\
hännes	h{n@s
happ	hAp
har	ha:R
här	hE:R
harespel	ha:R{sp@l
haseleg	hAz@l@s\
haule	h{:Ul@
haulen	h{:Ul@n
haus	h{:Us
hausdéiere	h{:Usd3I@R@
hausdéieren	h{:Usd3I@R@n
hausdier	h{:Usdi6
hausfra	h{:UsfRa:
hausschlëssel	h{:UsSl@s@l
haut	h{:Ut
haut	hAUt
hautdesdaags	hAUt@sda:Xs
héchstens	hekst@ns
heck	h{k
hee	he:
heed	he:t
heefeg	he:f@s\
heehapp	he:hAp
heekele	he:k@l@
heekelen	he:k@l@n
heel	he:l
heem	he:m
heemele	he:m@l@
heemelen	he:m@l@n
heemfuere	he:mfu@R@
heemfueren	he:mfu@R@n
heemgoe	he:mgo:@
heemgoen	he:mgo:@n
heemkomme	he:mkom@
heemkommen	he:mkom@n
heemlech	he:ml@s\
heepst	he:pst
hees	he:s
heesche	he:S@
heeschemann	he:S@mAn
heeschen	he:S@n
heesprénger	he:SpReN6
hëff	h@f
heft	h{ft
hei	hAI
heiansdo	hAIAnsdo:
heibanne	hAIbAn@
heibannen	hAIbAn@n
heibausse	hAIb{:Us@
heibaussen	hAIb{:Us@n
héich	h3Is\
héicht	h3Is\t
héiere	h3I@R@
héieren	h3I@R@n
héierenk	h3I@ReNk
heifir	hAIfi6
héiflech	h3Ifl@s\
héiflechkeet	h3Ifl@s\ke:t
heihin	hAIhin
heizkierper	hAItski@p6
heizung	hAItsuN
helikopter	helikopt6
hell	h{l
hëllef	h@l@f
hëllefe	h@l@f@
hëllefen	h@l@f@n
helleg	h{l@s\
hellewech	h{l@v{s\
helm	h{lm
hëlze	h@lts@
hëlzen	h@lts@n
hemmung	h{muN
héngerdéif	heN6d3If
héngerjuck	heN6z\uk
henker	h{Nk6
hënner	h@n6
hënnere	h@n@R@
hënneren	h@n@R@n
hënnescht	h@n@St
hënt	h@nt
herno	hE:Rno:
herrgott	hE:Rgot
herrgottsfréi	hE:RgotsfR3I
hetz	h{ts
hëtze	h@ts@
hëtzen	h@ts@n
hëtzt	h@tst
hex	h{ks
hexerei	h{ks@RAI
hick	hik
hickecht	hik@s\t
hidde	hid@
hidden	hid@n
hie	hi@
hiecht	hi:@s\t
hiefamm	hi:@vAm
hiel	hi@l
hielänner	hi@l{n6
hiem	hi@m
hiemche	hi@ms\@
hiemchen	hi@ms\@n
hien	hi@n
hier	hi6
hierk	hi6k
hierkomme	hi6kom@
hierkommen	hi6kom@n
hierscht	hi6St
hiert	hi6t
hieselnoss	hi@s@lnos
hieselter	hi@z@lt6
hiewe	hi@v@
hiewel	hi@v@l
hiewen	hi@v@n
hifuere	hifu@R@
hifueren	hifu@R@n
hikomme	hikom@
hikommen	hikom@n
hileeën	hile:@n
him	him
himmel	him@l
himmelblo	him@lblo:
himmlesch	himl@S
hinne	hin@
hinnen	hin@n
hinsicht	hinzis\t
hippe	hip@
hippen	hip@n
hir	hi6
hirsch	hiRS
hirschuel	hi6Su@l
hisiicht	hizi:s\t
histelle	hiSt{l@
histellen	hiSt{l@n
hiwwel	hiv@l
hochzäit	hoXts{:It
hochzäitsdag	hoXts{:Itsda:X
hocker	hok6
hoer	ho:6
hoerbiischt	ho:6bi:St
hoereg	ho:@R@s\
hoffe	hof@
hoffen	hof@n
hoffentlech	hof@ntl@s\
hoffnung	hofnuN
holland	holAnt
hollännesch	hol{n@S
holz	holts
holzbock	holtsbok
homard	homa:R
hond	hont
hondsfrieme	hontsfRi@m@
hondsfriemen	hontsfRi@m@n
hondsfriesse	hontsfRi@s@
hondsfriessen	hontsfRi@s@n
hondsgewéinlech	hontsg@v3Inl@s\
hondshaische	hontshAIsj@
hondshaischen	hontshAIsj@n
hondsléngt	hontsleNt
hong	hoN
honger	hoN6
hongereg	hoN@R@s\
honnert	hon6t
hörer	h2:R6
hotel	o:t{l
houer	h@U6
houfert	h@Uf6t
houfreg	h@UfR@s\
houscht	h@USt
houschte	h@USt@
houschten	h@USt@n
housecker	h@Usek6
housse	hus
hu	hu
huddele	hud@l@
huddelen	hud@l@n
huel	hu@l
huele	hu@l@
huelen	hu@l@n
huerele	hu@R@l@
huerelen	hu@R@l@n
huerteg	hu6t@s\
hues	hu@s
huesenziwwi	hu@s@ntsivi:
huewer	hu@v6
huewerbräi	hu@v6bR{:I
huff	huf
hummer	hum6
hummere	hum@R@
hummeren	hum@R@n
humpe	hump@
humpen	hump@n
humus	hu:mus
hunn	hun
hunneg	hun@s\
huppe	hup@
huppen	hup@n
hutt	hut
huwwel	huv@l
huwwele	huv@l@
huwwelen	huv@l@n
huwwelspoun	huv@lSp@Un
iddi	idi:
iech	i@s\
ielebou	i@l@b@U
ier	i6
ierbes	i6b@s
ierflech	i6fl@s\
ierfschaft	i6fSAft
iergend	i6z\@nt
iergendwou	i6z\@ntv@U
ierger	i6z\6
iergere	i6z\@R@
iergeren	i6z\@R@n
iergerlech	i6z\6l@s\
iertum	i6tum
ierwe	i6v@
ierwen	i6v@n
ierz	i6ts
iesel	i@z@l
iesse	i@s@
iessekascht	i@sekASt
iessen	i@s@n
iesses	i@s@s
iesswuere	i@svu@R@
iesswueren	i@svu@R@n
iesszëmmer	i@sts@m6
iewel	i@v@l
iewescht	i@v@St
ieweschte	i@v@St@
ieweschten	i@v@St@n
igel	ig@l
ignoréiere	iJoR3I@R@
ignoréieren	iJoR3I@R@n
illusioun	ilusj@Un
illustréiert	ilustR3I6t
immens	im{ns
impfe	impf@
impfen	impf@n
impfung	impfuN
import	impORt
indianer	india:n6
infam	infa:m
infinitiv	infiniti:f
infirmier	E~:fiRmje:
informatik	infORma:tik
ingenieur	E~:Z@nj9:R
insekt	inz{kt
insel	inz@l
installateur	E~:stAlAt9:R
instanz	instAnts
int	int
intche	ints\@
intchen	ints\@n
interview	intERvju:
intim	inti:m
intressant	intR{sAnt
intressi	intR{si
inversioun	invERzj@Un
invitatioun	E~:vitAsj@Un
invitéiere	E~:vit3I@R@
invitéieren	E~:vit3I@R@n
ire	i:R@
iren	i:R@n
italie	ita:li@
italien	ita:li@n
italienesch	itAlie:n@S
iwregens	ivR@z\@ns
iwwel	iv@l
iwwer	iv6
iwwerall	iv@RAl
iwwerbake	iv6ba:k@
iwwerbaken	iv6ba:k@n
iwwerbléck	iv6blek
iwwerdeems	iv6de:ms
iwwerdreiwe	iv6dRAIv@
iwwerdreiwen	iv6dRAIv@n
iwwerdroe	iv6dRo:@
iwwerdroen	iv6dRo:@n
iwwerenee	iv@R@ne:
iwwereneen	iv@R@ne:n
iwwerfale	iv6fa:l@
iwwerfalen	iv6fa:l@n
iwwerfloss	iv6flos
iwwerfuere	iv6fu@R@
iwwerfueren	iv6fu@R@n
iwwergi	iv6gi
iwwerginn	iv6gin
iwwerhaapt	iv6ha:pt
iwwerhuele	iv6hu@l@
iwwerhuelen	iv6hu@l@n
iwwerleeën	iv6le:@n
iwwerliewe	iv6li@v@
iwwerliewen	iv6li@v@n
iwwermar	iv6ma:R
iwwermuer	iv6mu:6
iwwerrasche	iv@RAS@
iwwerraschen	iv@RAS@n
iwwerraschung	iv@RASuN
iwwerreeche	iv@Re:s\@
iwwerreechen	iv@Re:s\@n
iwwerrenne	iv@R{n@
iwwerrennen	iv@R{n@n
iwwerriede	iv@Ri@d@
iwwerrieden	iv@Ri@d@n
iwwerschrëft	iv6SR@ft
iwwerschwemmung	iv6Sw{muN
iwwersetze	iv6s{ts@
iwwersetzen	iv6s{ts@n
iwwersiicht	iv6zi:s\t
iwwersprange	iv6SpRAN@
iwwersprangen	iv6SpRAN@n
iwwerstonn	iv6Ston
iwwert	iv6t
iwwerustrengung	iv6uStR{NuN
iwwerwaache	iv6va:X@
iwwerwaachen	iv6va:X@n
iwwerzeege	iv6tse:z\@
iwwerzeegen	iv6tse:z\@n
iwwerzeegung	iv6tse:z\uN
ja	ja:
jackett	ZAk{t
jäize	z\{:Its@
jäizeg	z\{:Its@s\
jäizen	z\{:Its@n
jalous	ZAl@Us
jalousheet	ZAl@Ushe:t
jalousie	ZAluzi:
januar	z\Anua:R
jarnéier	Za:Rn3I6
jatte	ZAt
jauwe	z\AUv@
jauwen	z\AUv@n
jeans	dZi:ns
jeeër	je6
jeeërlech	je:6l@s\
jéimere	z\3Im@R@
jéimeren	z\3Im@R@n
jelli	Zeli
jéngelche	z\eN@ls\@
jéngelchen	z\eN@ls\@n
jéngste	z\eNst@
jéngsten	z\eNst@n
jick	z\ik
jicke	z\ik@
jicken	z\ik@n
jiddefalls	z\id@fAls
jidder	z\id6
jidderee	z\id@Re:
jiddereen	z\id@Re:n
jiddweree	z\idf@Re:
jiddwereen	z\idf@Re:n
jilli	Zili:
jinsseg	z\ins@s\
jo	jo:
joe	jo:@
joen	jo:@n
joer	jo:6
joffer	jof6
jogge	dZog@
joggen	dZog@n
jogurth	juguRt
jong	joN
jonggesell	joNg@z{l
jongleur	ZA~:gl9:R
jonk	joNk
jor	jo:R
jorelaang	jo:Rela:N
jorhonnert	jo:Rhon6t
joshgun	joSgun
journalist	ZuRnAlist
judd	jut
judo	ju:do:
juegd	ju@s\t
jugend	ju:R@nt
jugendherberg	ju:R@nthE:6bERs\
juli	z\u:li
juni	z\u:ni
jupe	Zyp
jupon	ZypA~:
jus	Zy:
just	Zust
ka	kA
kaart	ka:Rt
kabel	ka:b@l
kabes	ka:b@s
kach	kAX
kachbuch	kAXbuX
kachcours	kAXku:6
kachdëppe	kAXd@p@
kachdëppen	kAXd@p@n
käche	k{s\@
kache	kAX@
kachegliddeg	kAX@glid@s\
kächen	k{s\@n
kachen	kAX@n
kachmaschinn	kAXmASin
kackelack	kAk@lAk
kackuett	kAkw{t
kadaver	kAda:v6
kader	ka:d6
käerche	kE:6s\@
käerchen	kE:6s\@n
käerz	kE:6ts
kaf	ka:f
kafe	ka:f@
käfeg	kE:f@s\
kafen	ka:f@n
kaffi	kAfi:
kaffisbiz	kAfi:sbi:ts
kaffisläffelche	kAfi:sl{f@lch@
kaffisläffelchen	kAfi:sl{f@lch@n
kaffismille	kAfi:smil@
kaffismillen	kAfi:smil@n
käiche	k{:Is\@
käichen	k{:Is\@n
kakao	kAkAo:
kal	ka:l
kalbass	kAlbAs
kalbliddeg	ka:lblid@s\
kalenner	kAl{n6
kall	kAl
kallef	kAl@f
kalleffleesch	kAl@ffle:S
kallefskotlett	kAl@fskotl{t
kallek	kAlek
kalzong	kAltsoN
kamäin	kAm{:In
kaméidi	kAm3Idi
kaméil	kAm3Il
kamell	kAm{ll
kamera	kAme:Ra:
kämme	k{m@
kämmen	k{m@n
kammoud	kAm@Ut
kammoudheet	kAm@Uthe:t
kamomill	kAmomil
kamp	kAmp
kampf	kAmpf
kämpfe	k{mpf@
kämpfen	k{mpf@n
kämpfer	k{mpf6
kan	ka:n
kanal	kAna:l
kanarievull	kAna:Ri@ful
kand	kAnt
kanddaf	kAntda:f
kanéngche	kAneNs\@
kanéngchen	kAneNs\@n
känguruh	k{NguRu:
kannereg	kAn@R@s\
kannerkutsch	kAn6kutS
kannerzëmmer	kAn6ts@m6
kantin	kAntin
kap	ka:p
kapéiere	kAp3I@R@
kapéieren	kAp3I@R@n
kaper	ka:p6
kapëtche	kAp@ts\@
kapëtchen	kAp@ts\@n
kapitel	kApit@l
kapp	kAp
kappkësse	kApk@s@
kappkëssen	kApk@s@n
kappsprong	kApSpRoN
kappwéi	kApv3I
kappzich	kAptsis\
kar	ka:R
kär	kE:R
karaff	kARAf
karate	kARa:te:
karblumm	ka:Rblum
karéiert	kAR3I6t
kärel	kE:R@l
kärgesond	kE:Rg@zont
karmell	kARm{l
karo	ka:Ro:
karschnatz	ka:RSnAts
kartong	kAXtoN
kartongskëscht	kAXtoNsk@St
kasär	kAzE:R
käscht	k{St
kascht	kASt
kaschte	kASt@
käschtebam	k{St@ba:m
kaschten	kASt@n
kassett	kAs{t
kassroll	kAsRol
katastrof	kAtAstRo:f
kathoulesch	kAt@Ul@S
katze	kAts@
katzen	kAts@n
kaum	k{:Um
kauzekapp	k{:Uts@kAp
kaviar	kAvia:R
kaweechelche	kAve:s\@ls\@
kaweechelchen	kAve:s\@ls\@n
kaz	ka:ts
këddele	k@d@l@
këddeleg	k@d@l@s\
këddelen	k@d@l@n
kee	ke:
keefer	ke:f6
keel	ke:l
keeleklatz	ke:l@klAts
keelt	ke:lt
keen	ke:n
kees	ke:s
keeser	ke:z6
keess	ke:s
kéidreck	k3IdR{k
kéier	k3I6
keime	kAIm@
keimen	kAIm@n
kéis	k3Is
kéisecker	k3Isek6
kéisrapp	k3IsRAp
kéistupp	k3IStup
keller	k{l6
kellertrap	k{l6tRa:p
këndche	k@nts\@
këndchen	k@nts\@n
keng	k{N
kéng	keN
kénge	keN@
kéngen	keN@n
kéngheet	keNhe:t
kënn	k@n
kenne	k{n@
kënne	k@n@
kënneg	k@n@s\
kënnege	k@n@z\@
kënnegen	k@n@z\@n
kennen	k{n@n
kënnen	k@n@n
kennschaft	k{nSAft
kënschtlech	k@nStl@s\
kënschtler	k@nStl6
këscht	k@St
kësse	k@s@
këssen	k@s@n
kette	k{t@
ketten	k{t@n
kiche	kis\@
kichebriet	kis\@bRi@t
kichelche	kis\@ls\@
kichelchen	kis\@ls\@n
kichemesser	kis\@m{s6
kichen	kis\@n
kichendësch	kis\@nd@S
kichenduch	kis\@nduX
kicheschaf	kis\@Sa:f
kichestull	kis\@Stul
kichewo	kis\@vo:
kickele	kik@l@
kickelen	kik@l@n
kidnappéiere	kitnAp3I@R@
kidnappéieren	kitnAp3I@R@n
kierb	ki6p
kierbiischt	ki6bi:St
kierch	ki6s\
kiere	ki6R@
kieren	ki6R@n
kierfche	ki6fs\@
kierfchen	ki6fs\@n
kierfecht	ki6f@s\t
kiermes	ki6m@s
kierper	ki6p6
kierze	ki6ts@
kierzen	ki6ts@n
kierzlech	ki6tsl@s\
kiewerlek	ki@v6lek
kiischt	ki:St
kiischtche	ki:Sts\@
kiischtchen	ki:Sts\@n
kiischtebam	ki:St@ba:m
kill	kil
kille	kil@
killen	kil@n
kilo	kilo:
kilometer	kilome:t6
king	kiN
kinge	kiN@
kingen	kiN@n
kinnek	kinek
kinnigin	kinigin
kino	kino:
kippe	kip@
kippen	kip@n
kiselstee	kiz@lSte:
kiselsteen	kiz@lSte:n
kitsch	kitS
kitscheg	kitS@s\
kiwwel	kiv@l
klaatsch	kla:tS
klaatsche	kla:tS@
klaatschen	kla:tS@n
klabbere	klAb@R@
klabberen	klAb@R@n
klack	klAk
klackespill	klAk@Spil
klam	kla:m
klamme	klAm@
klammen	klAm@n
klape	kla:p@
klapen	kla:p@n
klappbar	klApba:R
klappe	klAp@
klappen	klAp@n
kläpperei	kl{p@RAI
klapplued	klAplu@t
klarinett	klARin{t
klass	klAs
klätsche	kl{tS@
klätschen	kl{tS@n
klatz	klAts
klatzkapp	klAtskAp
klatzkäppeg	klAtsk{p@s\
klaue	klAU@
klauen	klAU@n
klauschter	kl{:USt6
kleed	kle:t
kleedche	kle:ts\@
kleedchen	kle:ts\@n
kleederbigel	kle:d6biz\@l
kleederbiischt	kle:d6bi:St
kleedergeschäft	kle:d6g@S{ft
kleederschaf	kle:d6Sa:f
kleedung	kle:duN
kleesche	kle:sj@
kleeschen	kle:sj@n
kleesper	kle:sp6
kléi	kl3I
kleng	kl{N
klénge	kleN@
klengegkeet	kl{N@s\ke:t
kléngen	kleN@n
klenglech	kl{Nl@s\
klensch	kl{nS
klëppelsteng	kl@p@lSt{N
klibber	klib6
klima	kli:ma:
klinik	klinik
klinzeg	klints@s\
klippe	klip@
klippen	klip@n
klo	klo:
kloe	klo:@
kloen	klo:@n
kloer	klo:6
klomp	klomp
klotere	klo:t@R@
kloteren	klo:t@R@n
klouschter	kl@USt6
kluck	kluk
kludder	klud6
klunsch	klunS
klunschele	klunS@l@
klunschelen	klunS@l@n
knabbele	knAb@l@
knabbelen	knAb@l@n
knabbere	knAb@R@
knabberen	knAb@R@n
knache	knAX@
knachen	knAX@n
knae	kna:@
knaen	kna:@n
knäipche	kn{:Ips\@
knäipchen	kn{:Ips\@n
knäipe	kn{:Ip@
knäipen	kn{:Ip@n
knapp	knAp
knäpplach	kn{plAX
knapps	knAps
knascht	knASt
knaschteg	knASt@s\
knätsch	kn{tS
knätsche	kn{tS@
knätschen	kn{tS@n
knätzele	kn{ts@l@
knätzelen	kn{ts@l@n
knausereg	knAUz@R@s\
knéchele	kn@s\@l@
knéchelen	kn@s\@l@n
knéckeg	knek@s\
knéckjang	knekZAN
knéi	kn3I
knéie	kn3I@
knéien	kn3I@n
knéischeif	kn3ISAIf
knëppel	kn@p@l
knëppelsteng	kn@p@lSt{N
kniddel	knid@l
kniede	kni@d@
knieden	kni@d@n
kniff	knif
knippche	knips\@
knippchen	knips\@n
knipse	knips@
knipsen	knips@n
kniwwele	kniv@l@
kniwwelen	kniv@l@n
knosp	knosp
knoutere	kn@Ut@R@
knoutereg	kn@Ut@R@s\
knouteren	kn@Ut@R@n
knubbeleg	knub@l@s\
knuet	knu@t
knuewelek	knu@v@lek
knupp	knup
knuppe	knup@
knuppen	knup@n
köder	k2:d6
koffer	kof6
kokett	kok{t
kolleg	kole:s\
kollegin	kole:z\in
kolonn	kolon
komerod	kom@Ro:t
komesch	ko:m@S
komiker	ko:mik6
komma	koma:
kommandéiere	komAnd3I@R@
kommandéieren	komAnd3I@R@n
komme	kom@
kommen	kom@n
kommissioun	komisj@Un
komp	komp
kompass	kompAs
kompetenz	kompe:t{nts
kompliment	komplim{nt
komplizéiert	komplits3I6t
komplottéiere	komplot3I@R@
komplottéieren	komplot3I@R@n
komponist	komponist
konditioun	konditsj@Un
konfus	konfu:s
konnschaft	konSAft
konscht	konSt
konschtwierk	konStvi6k
konserv	konzERf
konserven	konzERv@n
konsonant	konzonAnt
kont	kont
kontabilitéit	kontAbilit3It
kontakt	kontAkt
kontrolléiere	kontRol3I@R@
kontrolléieren	kontRol3I@R@n
kontroller	kontRol6
kontrolltuerm	kontRoltu6m
kopéiere	kop3I@R@
kopéieren	kop3I@R@n
kopi	kopi
koppel	kop@l
kopplabunz	koplAbunts
kork	koXk
koschter	koSt6
koschtere	koSt@R@
koschteren	koSt@R@n
koseng	kozeN
kostüm	kostym
kotlett	kotl{t
kotteng	koteN
kou	k@U
kouert	k@U6t
koup	k@Up
koustall	k@UStAl
koz	ko:ts
kraache	kRa:X@
kraachen	kRa:X@n
kraaft	kRa:ft
krabb	kRAp
krabbe	kRAb@
krabben	kRAb@n
kräid	kR{:It
kräijong	kR{:IjoN
kräische	kR{:IS@
kräischen	kR{:IS@n
kräiz	kR{:Its
kräize	kR{:Its@
kräizen	kR{:Its@n
kräizung	kR{:ItsuN
krall	kRAll
kramp	kRAmp
kran	kRa:n
krank	kRANk
krankeschwëster	kRANk@Sw@st6
krankheet	kRANkhe:t
krankheetskeim	kRANkhe:tskAIm
kranz	kRAnts
krapp	kRAp
krappeg	kRAp@s\
krauche	kR{:UX@
krauchen	kR{:UX@n
krausel	kRAUz@l
krauseleg	kRAUz@l@s\
kraut	kR{:Ut
krawatt	kRAvAt
kraze	kRa:ts@
krazen	kRa:ts@n
kréckele	kRek@l@
kréckelen	kRek@l@n
kreditkaart	kReditka:Rt
kreemche	kRe:ms\@
kreemchen	kRe:ms\@n
krees	kRe:s
kreesch	kRe:S
kregéile	kR@g3Il@
kregéilen	kR@g3Il@n
kréi	kR3I
kréie	kR3I@
kréien	kR3I@n
kréiena	kR3I@na:
kréimer	kR3Im6
kréischel	kR3IS@l
kréischelsheck	kR3IS@lsh{k
krëpeng	kR@peN
krëpp	kR@p
krëppel	kR@p@l
krëppeleg	kR@p@l@s\
kretsch	kR{tS
krich	kRis\
kriddeleg	kRid@l@s\
kriibs	kRi:ps
krimi	kRimi:
kristall	kRistAl
kriten	kRi:t@n
kritiséiere	kRitiz3I@R@
kritiséieren	kRitiz3I@R@n
krokodill	kRokodil
krom	kRo:m
kromm	kRom
krop	kRo:p
krou	kR@U
kroun	kR@Un
krunn	kRun
kruppschank	kRupSANk
krut	kRu:t
kruten	kRu:t@n
kuch	kuX
kucke	kuk@
kucken	kuk@n
kuddelfleck	kud@lfl{k
kueb	ku@p
kuebe	ku@b@
kueben	ku@b@n
kueder	ku@d6
kuel	ku@l
kuerf	ku6f
kuerz	ku6ts
kuerze	ku6ts@
kuerzen	ku6ts@n
kuerzsichteg	ku6tszis\t@s\
kugel	kuR@l
kulang	kulAN
kulisse	kulise
kulissen	kulisen
kummer	kum6
künstler	kynstl6
kupplung	kupluN
kur	ku:6
kurzschluss	ku6tsSlus
kuss	kus
kuuscht	ku:St
kuuschteg	ku:St@s\
kuuschtert	ku:St6t
laach	la:X
laache	la:X@
laachen	la:X@n
laang	la:N
laanscht	la:nSt
laanschtkomme	la:nStkom@
laanschtkommen	la:nStkom@n
laascht	la:St
labber	lAb6
lach	lAX
lächele	l{s\@l@
lächelen	l{s\@l@n
lächerlech	l{s\6l@s\
lackele	lAk@l@
lackeleg	lAk@l@s\
lackelen	lAk@l@n
laf	la:f
lafe	la:f@
lafen	la:f@n
läffel	l{f@l
läffelsgeschir	l{f@lsg@Si6
läich	l{:Is\
läif	l{:If
läilech	l{:Il@s\
läinduch	l{:InduX
läinzeeche	l{:Intse:s\@
läinzeechen	l{:Intse:s\@n
laitue	lE:ty
laitue	lE:ty:
lämmche	l{ms\@
lämmchen	l{ms\@n
land	lAnt
lande	lAnd@
landen	lAnd@n
landkaart	lAntka:Rt
landschaft	lAntSAft
landstrooss	lAntStRo:s
landung	lAnduN
landwirt	lAntviRt
länge	l{N@
längen	l{N@n
längt	l{Nt
langust	lANgust
langweil	lANvAIl
langweile	lANvAIl@
langweileg	lANvAIl@s\
langweilen	lANvAIl@n
lann	lAn
lanz	lAnts
läppche	l{ps\@
läppchen	l{ps\@n
läsche	l{S@
läschen	l{S@n
lass	lAs
lassgi	lAsgi
lassginn	lAsgin
lassgoe	lAsgo:@
lassgoen	lAsgo:@n
lassloosse	lAslo:s@
lassloossen	lAslo:s@n
lästeg	l{st@s\
lastik	lAstik
laude	lAUd@
lauden	lAUd@n
lauer	lAU6
lauere	lAU@R@
laueren	lAU@R@n
laufbursch	lAUfbuRS
laun	lAUn
launesch	lAUn@S
laus	l{:Us
lauschtere	l{:USt@R@
lauschteren	l{:USt@R@n
lauter	l{:Ut6
lautspriecher	l{:UtSpRi@s\6
lavabo	lAvAbo:
lavendel	lAv{nd@l
lawin	lAvi:n
lecke	l{k@
lecken	l{k@n
lee	le:
leechne	le:s\n@
leechnen	le:s\n@n
leed	le:t
leede	le:d@
leeden	le:d@n
leeder	le:d6
leeën	le:@n
leem	le:m
leeschte	le:St@
leeschten	le:St@n
leeschtung	le:StuN
lëfte	l@ft@
lëften	l@ft@n
leide	lAId@
leiden	lAId@n
leidenschaft	lAId@nSAft
leider	lAId6
leie	lAI@
léie	l3I@
leien	lAI@n
léien	l3I@n
leier	lAI6
léier	l3I6
léierbouf	l3I6b@Uf
leiere	lAI@R@
léiere	l3I@R@
leieren	lAI@R@n
léieren	l3I@R@n
léierin	l3I@Rin
léierjong	l3I6joN
léif	l3If
léift	l3Ift
léine	l3In@
léinen	l3In@n
léise	l3Iz@
léisegeld	l3Iz@g{lt
léisen	l3Iz@n
léislech	l3Isl@s\
léisung	l3IzuN
leit	lAIt
leitung	lAItuN
léiw	l3If
léiweckelche	l3Iv{k@ls\@
léiweckelchen	l3Iv{k@ls\@n
léiwemailche	l3Iv@mAIls\@
léiwemailchen	l3Iv@mAIls\@n
lektioun	l{ksj@Un
lëmmel	l@m@l
lëmmelzeg	l@m@lts@s\
léngent	leN@nt
léngt	leNt
lénks	leNks
lënnere	l@n@R@
lënneren	l@n@R@n
lëns	l@ns
leopard	leopa:Rt
lëppestëft	l@p@St@ft
lëps	l@ps
lescht	l{St
lëscht	l@St
leschte	l{St@
lëschteg	l@St@s\
leschten	l{St@n
lëtzebuerg	l@ts@bu6s\
lëtzebuerger	l@ts@bu6j6
lëtzebuergerin	l@ts@bu6j@Rin
lëtzebuergesch	l@ts@bu6j@S
libell	lib{l
liberal	lib@Ra:l
librairie	libR{Ri:
lidd	lit
liddereg	lid@R@s\
lidderhanes	lid6ha:n@s
lieder	li@d6
liefkuch	li@fkuX
lies	li@s
liese	li@z@
liesen	li@z@n
lieser	li@z6
liewe	li@ve
lieweg	li@v@s\
liewen	li@ven
liewer	li@veR
liewerkniddel	li@veRknid@l
liewesgeféierlech	li@vesg@f3I6l@s\
lieweskraaft	li@veskRa:ft
liewesmidd	li@vesmit
liewesraum	li@vesR{:Um
lift	lift
lige	liz\@
ligen	liz\@n
ligener	liz\@n6
ligestull	li:z\@Stul
liicht	li:s\t
liichtegkeet	li:s\t@s\ke:t
liichtmëssdag	li:s\tm@sda:X
liichtsënneg	li:s\tz@n@s\
limonad	limona:t
lineal	linea:l
liter	lit6
living	liviN
liwwere	liv@R@
liwweren	liv@R@n
liwwerwon	liv6vo:n
lo	lo:
locataire	lokAtE:R
loft	loft
loftballon	loftbAlA~:
lokomotiv	lokomoti:f
lokomotiven	lokomoti:v@n
lokomotivführer	lokomoti:ffy:R6
lomp	lomp
long	loN
loosse	lo:s@
loossen	lo:s@n
lorberblat	lORb6bla:t
losange	lozA~:S
loscht	loSt
louche	luS
loun	l@Un
loune	l@Un@
lounen	l@Un@n
lous	l@Us
loyer	lwAje:
luede	lu@d@
lueden	lu@d@n
luef	lu@f
lues	lu@s
lupp	lup
lüster	lyst6
lut	lu:t
lutsch	lutS
lutsche	lutS@
lutschen	lutS@n
luucht	lu:Xt
luuchteschalter	lu:Xt@SAlt6
luusse	lu:s@
luusseg	lu:s@s\
luussen	lu:s@n
luxuriéis	luksuRj3Is
luxus	luksus
lycée	lise:
ma	mA
maache	ma:X@
maachen	ma:X@n
maans	ma:ns
maart	ma:Rt
maartplaz	ma:Rtpla:ts
mächteg	m{s\t@s\
mackeg	mAk@s\
madame	mAdAm
mäerche	mE6s\@
mäerchen	mE6s\@n
mäerder	mE6d6
mäerderesch	mE6d@R@S
mäerz	mE6ts
magnéit	mAgn3It
mäifelche	m{:If@ls\@
mäifelchen	m{:If@ls\@n
maillot	mAjo:
mäin	m{:In
malaise	mAlE:s
malle	mAl
mam	mAm
mama	mAma:
manchett	mA~:S{t
mandel	mAnd@l
mandele	mAnd@l@
mandelen	mAnd@l@n
manéierlech	mAn3I6l@s\
manktem	mANkt@m
mann	mAn
manner	mAn6
mannerjäreg	mAn6jE:R@s\
männlech	m{nl@s\
mansard	mA~:sa:R
mantel	mAnt@l
mantelbriet	mAnt@lbRi@t
mapp	mAp
mar	ma:R
marber	mARb6
märei	m{RAI
märel	mE:R@l
margréitche	ma:RgR3Its\@
margréitchen	ma:RgR3Its\@n
marionett	mARion{t
masch	mAS
mask	mAsk
maskéieren	mAsk3I@R@n
mass	mAs
massage	mAsa:S
massaker	mAsAk6
masseg	mAs@s\
masseur	mAs9:R
masseuse	mAs2:s
mast	mAst
mastik	mAstik
masutt	mAzut
mat	mAt
matbrénge	mAtbReN@
matbréngen	mAtbReN@n
matdeele	mAtde:l@
matdeelen	mAtde:l@n
matenee	mAd@ne:
mateneen	mAd@ne:n
material	mAteRja:l
matgoe	mAtgo:@
matgoen	mAtgo:@n
mathematik	mAtema:tik
mathuele	mAthu@l@
mathuelen	mAthu@l@n
matleed	mAtle:t
matrass	mAtRAs
matrous	mAtR@Us
matschaffe	mAtSAf@
matschaffen	mAtSAf@n
matt	mAt
mauer	mAU6
maufel	m{:Uf@l
maulef	m{:Ul@f
maulkuerf	m{:Ulku6f
maus	m{:Us
mauséiercheszalot	mAUz3I6s\@stsAlo:t
mécanicien	me:kAnisjE~:
mech	m@s\
méchs	m@s\s
méck	mek
meckere	m{k@R@
meckeren	m{k@R@n
medail	m@dAIl
medezin	m@d@tsin
medikament	me:dikAm{nt
mee	me:
meedche	me:ts\@
meedchen	me:ts\@n
meederchesnumm	me:d6s\@snum
meenung	me:nuN
meeréische	me:R3Isj@
meeréischen	me:R3Isj@n
meescht	me:St
meeschtens	me:St@ns
meeschter	me:St6
meessel	me:s@l
meessele	me:s@l@
meesselen	me:s@l@n
mehrzahl	me:6tsa:l
méi	m3I
meide	mAId@
meiden	mAId@n
méie	m3I@
méien	m3I@n
méiglech	m3Iz\l@s\
méiglechkeet	m3Iz\l@s\ke:t
méiglechst	m3Iz\l@s\st
méimaschinn	m3ImASin
méindeg	m3Ind@s\
méindes	m3Ind@s
méintlaang	m3Intla:N
méisseg	m3Is@s\
méiw	m3If
méiwe	m3Iv@
méiwen	m3Iv@n
melde	m{ld@
melden	m{ld@n
meldung	m{lduN
mëll	m@l
melle	m{l@
mëllech	m@l@s\
mëllechquoten	m@l@s\kwo:t@n
mëllechzant	m@l@s\tsAnt
mellen	m{l@n
mëller	m@l6
meloun	m@l@Un
mëlz	m@lts
member	mA~:mb6
memberen	mA~:mb@R@n
mëndlech	m@ndl@s\
mëndlecht	m@ndl@s\t
meng	meN
menge	m{N@
menge	meN@
mengem	meN@m
mengen	m{N@n
mengen	meN@n
menger	meN6
mënsch	m@nS
mënschlech	m@nSl@s\
menu	m@ny:
menuskaart	m@ny:ska:Rt
mënz	m@nts
mer	m6
merci	mERsi:
mësch	m@S
mësche	m@S@
mëschen	m@S@n
mëscht	m@St
mëschung	m@SuN
message	m{sa:S
mëssbrauch	m@sbR{:UX
mëssbrauche	m@sbR{:UX@
mëssbrauchen	m@sbR{:UX@n
messer	m{s6
mësserfolleg	m@z6fol@s\
mëssgeschéck	m@sg@Sek
mësstraue	m@stRAU@
mësstrauen	m@stRAU@n
mësstrauesch	m@stRAU@S
meter	me:t6
mëtt	m@t
mëtteg	m@t@s\
mëttegiesse	m@t@s\i@s@
mëttegiessen	m@t@s\i@s@n
mëttelméisseg	m@t@lm3Is@s\
mëttelste	m@t@lst@
mëttelsten	m@t@lst@n
mëtternuecht	m@t6nu@s\t
mëttes	m@t@s
mëttespaus	m@t@spAUs
mëttesrascht	m@t@sRASt
mëttwoch	m@twoX
mëttwochs	m@twoXs
metzler	m{tsl6
metzlerei	m{tsl@RAI
miaue	mi:AU@
miauen	mi:AU@n
midd	mit
middegkeet	mid@s\ke:t
miel	mi@l
mier	mi6
mierf	mi6f
mierke	mi6k@
mierken	mi6k@n
mierschwéngche	mi6SweNs\@
mierschwéngchen	mi6SweNs\@n
mierstär	mi6StE:R
migrän	migRE:n
miissche	mi:sj@
miisschen	mi:sj@n
miissercher	mi:s6s\6
mikro	mikRo:
mille	mil@
millen	mil@n
minister	minist6
minn	min
minutt	minut
mippche	mips\@
mippchen	mips\@n
mir	mi6
misär	mizE:R
miwléiere	mivl3I@R@
miwléieren	mifl3I@R@n
miwwel	miv@l
mixer	miks6
mo	mo:
mobiliséiere	mobiliz3I@R@
mobiliséieren	mobiliz3I@R@n
mockeleg	mok@l@s\
modell	mod{l
modern	modERn
moer	mo:6
mof	mo:f
moie	moj@
moien	moj@n
moies	moj@s
mokuch	mo:kuX
mol	mo:l
molbier	mo:lbi6
mole	mo:l@
molen	mo:l@n
moler	mo:l6
molstëfter	mo:lSt@ft6
moment	mom{nt
momper	momp6
mond	mont
mondharmonika	monthARmo:nika:
moniteur	monit9:R
monni	moni:
monsieur	m@sj2:
monster	monst6
montéiere	mA~:t3I@R@
montéieren	mA~:t3I@R@n
monter	mont6
monterkeet	mont6ke:t
moolzecht	mo:lts@s\t
moos	mo:s
mooss	mo:s
moosse	mo:s@
moossen	mo:s@n
mopp	mop
mord	mORt
moschter	moSt6
moschtert	moSt6t
moss	mos
motivéiere	motiv3I6@
motivéieren	motiv3I6@n
motor	moto:R
motorboot	moto:Rbo:t
motorrad	moto:RRa:t
motze	mots@
motzen	mots@n
moud	m@Ut
mouk	m@Uk
mound	m@Unt
mount	m@Unt
moustique	mustik
muckse	muks@
mucksen	muks@n
mudder	mud6
mudderschrauf	mud6SRAUf
mued	mu@t
muedebëtzeg	mu@d@b@ts@s\
muele	mu@l@
muelen	mu@l@n
muer	mu:6
muerch	mu6s\
muere	mu@R@
mueren	mu@R@n
mueres	mu@R@s
muert	mu6t
mull	mul
mullebutz	mul@buts
mumps	mumps
munch	muns\
munnech	mun@s\
mupp	mup
muschel	muS@l
musée	my:ze:
musek	muzek
museker	muzek6
muskel	musk@l
musse	mus@
mussen	mus@n
muster	must6
mutt	mut
muttwëlleg	mutv@l@s\
muttwëlles	mutv@l@s
mutz	muts
naache	na:X@
naachen	na:X@n
naass	na:s
nach	nAX
nächst	nE:kst
nächste	n{kst@
nächsten	n{kst@n
nahrung	na:RuN
näid	n{:It
näipe	n{:Ip@
näipen	n{:Ip@n
näischnotz	n{:ISnots
näischnotzeg	n{:ISnots@s\
näischt	n{:ISt
naiv	na:i:f
namensdag	na:m@nsda:X
nämlech	nE:ml@s\
nappe	nAp
narb	nARp
narbe	nARb@
narben	nARb@n
naschele	nAS@l@
nascheleg	nAS@l@s\
naschelen	nAS@l@n
nascht	nASt
nashorn	na:shORn
natierlech	nAti6l@s\
national	nAtsjo:na:l
nationalitéit	nAtsjo:nAlit3It
natur	nAtu:R
naupe	n{:Up@
naupen	n{:Up@n
nawell	nAv{l
nee	ne:
neel	ne:l
neelche	ne:ls\@
neelchen	ne:ls\@n
neelchesblumm	ne:ls\@sblum
neelcheskapp	ne:ls\@skAp
neele	ne:l@
neelen	ne:l@n
neen	ne:n
nees	ne:s
nei	nAI
néideg	n3Id@s\
neidesch	nAId@S
neiegkeet	nAI@s\ke:t
néierens	n3I@R@ns
néiesch	n3I@S
neijooschdag	nAIjo:Sda:X
neimoudesch	nAIm@Ud@S
néitsche	n3ItS@
néitschen	n3ItS@n
néize	n3Its@
néizen	n3Its@n
nëmme	n@m@
nëmmen	n@m@n
néng	neN
néngte	neNt@
néngten	neNt@n
nerv	nERf
nerve	nERv@
nerven	nERv@n
nervös	nERv2:s
nëssert	n@s6t
net	n@t
netz	n{ts
netze	n{ts@
netzen	n{ts@n
nëtzlech	n@tsl@s\
netzt	n{tst
neveu	n@v2:
ni	ni:
niddereg	nid@R@s\
nidderlag	nid6la:X
nidderleeën	nid6le:@n
nidderschloe	nid6Slo:@
nidderschloen	nid6Slo:@n
nidderträchteg	nid6tR{s\t@s\
nieft	ni@ft
nier	ni6
niere	ni:R@
nieren	ni:R@n
nies	ni@s
niewebäi	ni@v@b{:I
niewent	ni@v@nt
nilpäerd	ni:lpE:6t
nimools	ni:mo:ls
niwwel	niv@l
niwweleg	niv@l@s\
no	no:
nobäi	no:b{:I
nobel	no:b@l
nodeel	no:de:l
nodenke	no:d{Nk@
nodenken	no:d{Nk@n
nogi	no:gi
noginn	no:gin
nogoe	no:go:@
nogoen	no:go:@n
nohuele	no:hu@l@
nohuelen	no:hu@l@n
nokucke	no:kuk@
nokucken	no:kuk@n
nol	no:l
nolauschtere	no:l{:USt@R@
nolauschteren	no:l{:USt@R@n
nolauschterer	no:l{:USt@R6
nole	no:l@
noléisseg	no:l3Is@s\
nolen	no:l@n
noliese	no:li@z@
noliesen	no:li@z@n
nom	no:m
nomëtteg	no:m@t@s\
nomëttes	no:m@t@s
nondikass	nondikAs
nonzeg	nonts@s\
nonzéng	nontseN
noper	no:p6
noperschaft	no:p6SAft
nopesch	no:p@S
norde	nORd@
norden	nORd@n
normal	nORma:l
noss	nos
notär	notE:R
notéiere	not3I@R@
notéieren	not3I@R@n
notiz	notits
notizbuch	notitsbuX
notze	nots@
notzen	nots@n
nout	n@Ut
noutdéngscht	n@UtdeNSt
noutwenneg	n@Utv{n@s\
noutwennegkeet	n@Utv{n@s\ke:t
nouvelle	nuv{l
november	nov{mb6
nu	nu:
nuddel	nud@l
nuebel	nu@b@l
nuecht	nu@s\t
nuechtegailche	nu@s\t@gAIls\@
nuechtegailchen	nu@s\t@gAIls\@n
nuechtelaang	nu@s\t@la:N
nuechtiesse	nu@z\di@s@
nuechtiessen	nu@z\di@s@n
nues	nu@s
nueslach	nu@slAX
nuets	nu@ts
nuetsdësch	nu@tsd@S
nuetshiem	nu@tshi@m
nuetspäiperlek	nu@tsp{:Ip6lek
null	nul
numero	num@Ro:
numm	num
nummer	num6
ob	op
obwuel	opvu@l
occasioun	okAzj@Un
och	oX
ochs	oks
oder	o:d6
ofbotze	o:fbots@
ofbotzen	o:fbots@n
ofbrenne	o:fbR{n@
ofbrennen	o:fbR{n@n
ofdanke	o:fdANk@
ofdanken	o:fdANk@n
ofdichte	o:fdis\t@
ofdichten	o:fdis\t@n
ofdréchne	o:fdR@s\n@
ofdréchnen	o:fdR@s\n@n
ofdreiwe	o:fdRAIv@
ofdreiwen	o:fdRAIv@n
offall	o:ffAl
offréiere	ofR3I@R@
offréieren	ofR3I@R@n
ofgerënnt	o:fg@R@nt
ofgi	o:fgi
ofginn	o:fgin
ofgoe	o:fgo:@
ofgoen	o:fgo:@n
ofgotzele	o:fgots@l@
ofgotzelen	o:fgots@l@n
ofhake	o:fha:k@
ofhaken	o:fha:k@n
ofhale	o:fha:l@
ofhalen	o:fha:l@n
ofhängeg	o:fh{N@s\
ofhängegkeet	o:fh{N@s\ke:t
ofhänke	o:fh{Nk@
ofhänken	o:fh{Nk@n
ofhuele	o:fhu@l@
ofhuelen	o:fhu@l@n
ofkierze	o:fki6ts@
ofkierzen	o:fki6ts@n
ofkierzung	o:fki6tsuN
ofkille	o:fkil@
ofkillen	o:fkil@n
oflafe	o:fla:f@
oflafen	o:fla:f@n
ofléis	o:fl3Is
ofléise	o:fl3Iz@
ofléisen	o:fl3Iz@n
ofluede	o:flu@d@
oflueden	o:flu@d@n
ofrappe	o:fRAp@
ofrappen	o:fRAp@n
ofraume	o:fRAUm@
ofraumen	o:fRAUm@n
ofrënne	o:fR@n@
ofrënnen	o:fR@n@n
ofschafe	o:fSa:f@
ofschafen	o:fSa:f@n
ofschlécke	o:fSlek@
ofschlécken	o:fSlek@n
ofschleefe	o:fSle:f@
ofschleefen	o:fSle:f@n
ofschreiwe	o:fSRAIv@
ofschreiwen	o:fSRAIv@n
ofschwäche	o:fSw{s\@
ofschwächen	o:fSw{s\@n
ofso	o:fzo:
ofsoe	o:fzo:@
ofsoen	o:fzo:@n
ofspäre	o:fSpE:R@
ofspären	o:fSpE:R@n
ofstand	o:fStAnt
ofstänn	o:fSt{n
ofstreide	o:fStRAId@
ofstreiden	o:fStRAId@n
oft	oft
ofwiessele	o:fvi@s@l@
ofwiesselen	o:fvi@s@l@n
oktober	okto:b6
oliv	oli:f
om	om
omelett	om@l{t
onbedéngt	onb@deNt
onbestänneg	onb@St{n@s\
onbestëmmt	onb@St@mt
ondankbar	ondANkba:R
ondenkbar	ond{Nkba:R
onéierlech	on3I6l@s\
onendlech	on{ndl@s\
onerhéiert	on6h3I6t
onerwaart	on6va:Rt
onfrëndlech	onfR@ndl@s\
ongär	ongE:R
ongedëlleg	ong@d@l@s\
ongedold	ong@dolt
ongeféier	ong@f3I6
ongemiddelt	ong@mid@lt
ongenéiert	onZ@n3I6t
ongeschécklech	ong@Sekl@s\
ongesond	ong@zont
ongewinnt	ong@vint
ongezillt	ong@tsilt
ongeziwwer	ong@tsiv6
ongezwonge	ong@tswoN@
ongezwongen	ong@tswoN@n
ongläich	ongl{:Is\
ongléck	onglek
onglécklech	onglekl@s\
onglécklecherweis	onglekl@s\6vAIs
onheemlech	onhe:ml@s\
onkammoud	onkAm@Ut
onkraut	onkR{:Ut
onmanéierlech	onmAn3I6l@s\
onmass	onmAs
onméiglech	onm3Iz\l@s\
onnëtz	on@ts
onofhängeg	ono:fh{N@s\
onofhängegkeet	ono:fh{N@s\ke:t
onrecht	onR{s\t
onrou	onR@U
onroueg	onR@U@s\
ons	ons
onschiedlech	onSiedl@s\
onschold	onSolt
onsécher	ons@s\6
ontrei	ontRAI
onuerdnung	onu6dnuN
onvergiesslech	onf6gi@sl@s\
onverhofft	onf6hoft
onverschimt	onf6Simt
onverschimtheet	onf6Simthe:t
onvirsichteg	onfi6zis\t@s\
onvirsichtegkeet	onfi6zis\t@s\ke:t
onzefridde	onts@fRid@
onzefridden	onts@fRid@n
ootme	o:tm@
ootmen	o:tm@n
ootmung	o:tmuN
op	op
opbesserung	opb{s6uN
opblose	opblo:z@
opblosen	opblo:z@n
opdrag	opdRa:X
opdränge	opdR{N@
opdrängen	opdR{N@n
opdréie	opdR3I@
opdréien	opdR3I@n
openthalt	ob@nthAlt
oper	o:p6
operéiere	op@R3I@R@
operéieren	op@R3I@R@n
operett	o:p@R{t
opfale	opfa:l@
opfalen	opfa:l@n
opfänke	opf{Nk@
opfänken	opf{Nk@n
opfriesse	opfRi@s@
opfriessen	opfRi@s@n
opgedonnert	opg@don6t
opgepasst	opg@pAst
opgi	opgi
opginn	opgin
opgoe	opgo:@
opgoen	opgo:@n
ophale	opha:l@
ophalen	opha:l@n
ophänke	oph{Nk@
ophänken	oph{Nk@n
ophiewe	ophi@v@
ophiewen	ophi@v@n
opkéipe	opk3Ip@
opkéipen	opk3Ip@n
opluede	oplu@d@
oplueden	oplu@d@n
opmierksam	opmi6ksa:m
opmierksamkeet	opmi6ksa:mke:t
oppasse	oppAs@
oppassen	oppAs@n
oppassert	oppAs6t
oprafe	opRa:f@
oprafen	opRa:f@n
opraume	opRAUm@
opraumen	opRAUm@n
opreege	opRe:z\@
opreegen	opRe:z\@n
opreegung	opRe:z\uN
oprichteg	opRi:s\t@s\
opriichte	opRi:s\t@
opriichten	opRi:s\t@n
oprulle	opRul@
oprullen	opRul@n
opschreiwe	opSRAIv@
opschreiwen	opSRAIv@n
opschuppe	opSup@
opschuppen	opSup@n
opsiicht	opzi:s\t
opsoe	opzo:@
opsoen	opzo:@n
opsprange	opSpRAN@
opsprangen	opSpRAN@n
opstoe	opSto:@
opstoen	opSto:@n
opsuckele	opzuk@l@
opsuckelen	opzuk@l@n
optiker	optik6
opweise	opvAIz@
opweisen	opvAIz@n
opwierme	opwi6m@
opwiermen	opwi6m@n
opwuesse	opwu@s@
opwuessen	opwu@s@n
opziele	optsi@l@
opzielen	optsi@l@n
orange	oRA~:S
orangejus	oRA~:S@Zy:
organisatioun	ORga:niza:tsj@Un
organiséiere	ORga:niz3I@R@
organiséieren	ORga:niz3I@R@n
orthographie	ORtogRAfi:
oste	ost@
osten	ost@n
otem	o:t@m
otempaus	o:t@mpAUs
ouer	@U6
ouerenentzündung	@U@R@n{nttsynduN
ouerläppche	@U6l{ps\@
ouerläppchen	@U6l{ps\@n
ouerréng	@U6ReN
ouerschlëffer	@U6Sl@f6
ouni	@Uni:
ouschtere	@USt@R@
ouschteren	@USt@R@n
ouschterhues	@USt6hu@s
oval	ova:l
owend	o:v@nt
owendiesse	o:v@ndi@s@
owendiessen	o:v@ndi@s@n
ower	o:v6
owes	o:v@s
owescours	o:v@sku:6
oweskleed	o:v@skle:t
paangech	pa:N@s\
paart	pa:Rt
pabeier	pAbAI6
pabeierkuerf	pAbAI6ku@f
packe	pAk@
packen	pAk@n
pad	pa:t
paddel	pAd@l
paddelboot	pAd@lbo:t
paddele	pAd@l@
paddelen	pAd@l@n
päerd	pE:6t
päerdercher	pE:6d6s\6
päerdsbier	pE:6tsbi6
päerdsstall	pE:6tsStAl
paff	pAf
pai	pAI
päif	p{:If
päife	p{:If@
päifen	p{:If@n
paillette	pAI{t
päinetsch	p{:In{tS
päiperlek	p{:Ip6lek
päischte	p{:ISt@
päischten	p{:ISt@n
pak	pa:k
pake	pa:k@
paken	pa:k@n
palais	pAlE:
palier	pAlie:
paltong	pAltoN
pampelmuss	pAmp@lmus
pan	pa:n
pand	pAnt
panda	pAnda:
panech	pa:n@s\
panewippche	pa:n@vips\@
panewippchen	pa:n@vips\@n
pann	pAn
panz	pAnts
papagei	pApAgAI
papeg	pa:p@s\
papp	pAp
paräis	pAR{:Is
parat	pARa:t
paravent	pARAvA~:
parcours	pARku:6
pardon	pARdA~:
parechoc	pa:RSok
pärel	pE:R@l
parfum	pARfE~:
parfümerie	pARfym@Ri:
park	pARk
parke	pARk@
parken	pARk@n
parkplaz	pARkpla:ts
parlamentaresch	pARla:m{nta:R@S
parréck	pARek
partie	pARti:
partner	pARtn6
party	pa:Rti:
parzeläin	pARts@l{:In
parzell	pARts{l
paschtouer	pASt@U6
pass	pAs
passagéier	pAsAZ3I6
passe	pAs@
passen	pAs@n
passepartout	pAspARtu:
passette	pAs{t
passfoto	pAsfoto:
pater	pa:t6
patient	pAtsj{nt
patisserie	pAtis@Ri:
patissier	pAtisje:
patsch	pAtS
patt	pAt
pätter	p{t6
paus	pAUs
pautsch	p{:UtS
pawee	pAve:
péage	pe:a:S
pech	p{s\
peche	p{s\@
pecheg	p{s\@s\
pechen	p{s\@n
pedall	p@dAl
pédicure	pe:diky:R
peffer	p{f6
peffermanztéi	p{f6mAntst3I
péiterséilech	p3It6z3Il@s\
pelikan	pe:lika:n
pëll	p@l
pellem	p{l@m
pelz	p{lts
péng	peN
péngeche	peN@s\@
péngechen	peN@s\@n
péngschte	peNSt@
péngschten	peNSt@n
penibel	pe:ni:b@l
péniche	pe:niS
pénktlech	peNktl@s\
pensée	pA~:se:
pënsel	p@nz@l
pensionéiert	p{nsjo:n3I6t
pëppel	p@p@l
perfekt	pERf{kt
permanente	pERmAnA~:t
permis	pERmi:
perruche	p{RyS
perséinlech	pERz3Inl@s\
personal	pERzona:l
persoun	pERz@Un
pescht	p{St
pëspere	p@sp@R@
pësperen	p@sp@R@n
pëtrolstanker	p@tRolstANk6
pëtz	p@ts
pëtze	p@ts@
pëtzen	p@ts@n
petzi	p{tsi:
phare	fa:R
phonetik	fone:tik
piano	pjAno:
picke	pik@
pickeg	pik@s\
picken	pik@n
picknick	piknik
piddele	pid@l@
piddelen	pid@l@n
piff	pif
piije	pi:Z@
piijen	pi:Z@n
piisch	pi:S
pilger	pilz\6
pilgerplaz	pilz\6pla:ts
pillem	pil@m
pilot	pilo:t
pilz	pilts
pinguin	piNgui:n
pinsche	pinS@
pinschen	pinS@n
pinsel	pinz@l
piscine	pisin
pisse	pis@
pissen	pis@n
pist	pist
pittoresk	pitoR{sk
pizza	pitsa:
placard	plAka:R
plack	plAk
plackespiller	plAk@Spil6
plädéiere	plE:d3I@R@
plädéieren	plE:d3I@R@n
plafong	plAfoN
plafonnéier	plAfon3I6
plage	pla:S
plakapp	pla:kAp
plakäppeg	pla:k{p@s\
plakat	plAka:t
plakeg	pla:k@s\
planéiere	plAn3I@R@
planéieren	plAn3I@R@n
planet	plAne:t
plang	plAN
plange	plAN@
plangen	plAN@n
planz	plAnts
planze	plAnts@
planzen	plAnts@n
plastik	plAstik
plastikstut	plAstikstu:t
plastilin	plAstilin
plateau	plAto:
plätschnaass	pl{tSna:s
platt	plAt
plättche	pl{ts\@
plättchen	pl{ts\@n
platte	plAt@
platten	plAt@n
platze	plAts@
platzen	plAts@n
plaz	pla:ts
plécke	plek@
plécken	plek@n
plënnere	pl@n@R@
plënneren	pl@n@R@n
pleséier	pl@z3I6
plo	plo:
ploe	plo:@
ploen	plo:@n
plomm	plom
plooschter	plo:St6
plott	plot
plou	pl@U
ploue	pl@U@
plouen	pl@U@n
plover	plo:v6
plüschdéier	plySd3I6
pneu	pn2:
pohunn	po:hun
poléiere	pol3I@R@
poléieren	pol3I@R@n
politiker	politik6
polizei	politsAI
polizist	politsist
polnesch	poln@S
polstere	polst@R@
polsteren	polst@R@n
polver	polf6
polykopéiere	polikop3I@R@
polykopéieren	polikop3I@R@n
pompel	pomp@l
pompele	pomp@l@
pompelen	pomp@l@n
pompjee	pompZe:
pompjeesauto	pompZe:zAUto:
pond	pont
pony	poni:
popcorn	popkO:Rn
popp	pop
poppenhaus	pop@nh{:Us
porrett	poR{t
portefeuille	pORt@f9j
portemanteau	pORtmA~:to:
portier	pORtje:
portioun	pORtsj@Un
portmonni	pORtmoni:
portugal	pORtu:gAl
portugisesch	pORtugi:z@S
posch	poS
post	post
poteau	poto:
potere	po:t@R@
poteren	po:t@R@n
potti	poti:
poufank	p@UfANk
pouke	p@Uk@
pouken	p@Uk@n
poul	p@Ul
poulet	pule:
poulriicht	p@UlRi:s\t
poussette	pus{t
pouster	p@Ust6
pouze	p@Uts@
pouzen	p@Uts@n
prabbeli	pRAb@li:
praffe	pRAf@
praffen	pRAf@n
präis	pR{:Is
praktesch	pRAkt@S
praum	pRAUm
praxis	pRAksis
präzis	pRE:tsi:s
préiwe	pR3Iv@
préiwen	pR3Iv@n
premiere	pR@mje:@
première	pR@mjE:R
prënz	pR@nts
préparatioun	pRe:pARAtj@Un
presentatioun	pRezA~:nta:tsj@Un
presentéieren	pRezA~:nt3I@R@n
presse	pR{s@
pressen	pR{s@n
pressessioun	pR{s@sj@Un
pressioun	pR{sj@Un
presslofthummer	pR{slofthum6
prêt	pRE:
prett	pR{t
priedege	pRi@d@z\@
priedegen	pRi@d@z\@n
primärschoul	pRimE:RS@Ul
prinzessin	pRints{sin
prisong	pRizoN
prisonnéier	pRizon3I6
privat	pRiva:t
pro	pRo:
probéiere	pRob3I@R@
probéieren	pRob3I@R@n
problem	pRoble:m
produkt	pRodukt
produktioun	pRoduksj@Un
produzéiere	pRoduts3I@R@
produzéieren	pRoduts3I@R@n
professer	pRof{s6
professesch	pRof{s@S
profezeie	pRof@tsAI@
profezeien	pRof@tsAI@n
profit	pRofit
profitéiere	pRofit3I@R@
profitéieren	pRofit3I@R@n
programm	pRogRAm
programméiere	pRogRAm3I@R@
programméieren	pRogRAm3I@R@n
projet	pRoZe:
projeten	pRoZe:@n
projets	pRoZe:
proklaméiere	pRoklAm3I@R@
proklaméieren	pRoklAm3I@R@n
prominent	pRomin{nt
promm	pRom
pronom	pRonA~:
pronome	pRonA~:@
pronomen	pRonA~:@n
propeller	pRop{l6
proposéiere	pRopo:z3I@R@
proposéieren	pRopo:z3I@R@n
propper	pRop6
propretéit	pRopR@t3It
prospekt	pRosp{kt
prost	pRost
proste	pRost@
prosten	pRost@n
protein	pRote:i:n
prouwe	pR@Uv@
prouwen	pR@Uv@n
prozent	pRots{nt
pruecht	pRu@s\t
prüfung	pRy:fuN
psalm	psa:lm
psychanalys	psikAna:li:s
psychesch	psi:s\@S
psychescher	psis\@S6
psychiater	psikja:t6
psychiatresch	psikja:tR@S
psychoanalys	psiko:Ana:li:s
psychoanalyse	psiko:Ana:li:z@
psychologie	psiko:lo:Zi:
psychos	psiko:s
publicitéit	pyblisit3It
publizéiere	pyblits3I@R@
publizéieren	pyblits3I@R@n
puche	puX@
puchen	puX@n
pudder	pud6
puddere	pud@R@
pudderen	pud@R@n
puer	pu6
puff	puf
puffe	puf@
puffen	puf@n
puffere	puf@R@
pufferen	puf@R@n
pujel	puZ@l
pull	pul
pullover	pulo:v6
pünäs	pynE:s
punkt	puNkt
pupeg	pu:p@s\
puppelche	pup@ls\@
puppelchen	pup@ls\@n
puppsat	pupza:t
purée	py:Re:
putsch	putS
pyjama	piZAma:
quai	kE:
quake	kwa:k@
quaken	kwa:k@n
quäle	kwE:l@
quälen	kwE:l@n
qualitéit	kAlit3It
quantitéit	kAntit3It
quartier	kARtje:
quatsch	kwAtS
queesch	kwe:S
quell	kw{l
quetsch	kw{tS
quetschekraut	kw{tS@kR{:Ut
queue	k2:
quiitsche	kwi:tS@
quiitschen	kwi:tS@n
quittung	kwituN
raache	Ra:X@
raachen	Ra:X@n
raaspel	Ra:sp@l
raaspele	Ra:sp@l@
raaspelen	Ra:sp@l@n
rabatt	RAbAt
rabbele	RAb@l@
rabbelen	RAb@l@n
räbbi	R{bi:
rabbiner	RAbin6
rach	RAX
räche	RE:s\@
rächen	RE:s\@n
rack	RAk
rad	Ra:t
radau	RAdAU
raddereg	RAd@R@s\
radio	Ra:djo:
rafe	Ra:f@
rafen	Ra:f@n
raffinéiert	RAfin3I6t
rahm	Ra:m
raiber	RAIb6
räich	R{:Is\
räichtum	R{:Is\tum
räif	R{:If
räis	R{:Is
rakéit	RAk3It
rambli	RAmbli:
rang	RAN
rank	RANk
rapp	RAp
rappe	RAp@
rappecht	RAp@s\t
rappen	RAp@n
rapport	RApO:R
räpse	R{ps@
räpsen	R{ps@n
raquette	RAk{t
rar	Ra:R
rascht	RASt
raschte	RASt@
raschteg	RASt@s\
raschten	RASt@n
rass	RAs
rat	Ra:t
rätsel	RE:ts@l
rau	R{:U
raum	R{:Um
raume	RAUm@
raumen	RAUm@n
raumschëff	R{:UmS@f
raup	R{:Up
raut	R{:Ut
razeg	Ra:ts@s\
reaktioun	ReAksj@Un
réaliséiere	ReAliz3I@R@
réaliséieren	ReAliz3I@R@n
rebbi	R{bi:
réceptionniste	Re:s{psjo:nist
receptioun	Re:s{psj@Un
rechemaschinn	R{s\@mASin
recherche	R@SERS
rechne	R{s\n@
rechnen	R{s\n@n
rechnung	R{s\nuN
recht	R{s\t
rechteck	R{z\d{k
rechts	R{s\ts
réck	Rek
réckele	Rek@l@
réckelen	Rek@l@n
ree	Re:
reebou	Re:b@U
reech	Re:s\
reeche	Re:s\@
reechen	Re:s\@n
reedel	Re:d@l
reef	Re:f
reell	Re:{l
reemantel	Re:mAnt@l
reen	Re:n
reene	Re:n@
reeneg	Re:n@s\
reenen	Re:n@n
rees	Re:s
reese	Re:z@
reesen	Re:z@n
reewaasser	Re:wa:s6
reewuerm	Re:vu6m
refuséiere	R@fy:z3I@R@
refuséieren	R@fy:z3I@R@n
regard	R@ga:R
regel	Re:z\@l
regelméisseg	Re:z\@lm3Is@s\
regierung	Re:z\i:RuN
régime	Re:Zim
réglage	Re:gla:S
rei	RAI
réi	R3I
reide	RAId@
reiden	RAId@n
réiere	R3I@R@
réieren	R3I@R@n
reim	RAIm
reiser	RAIz6
reiwe	RAIv@
reiwen	RAIv@n
reklam	R@klAm
reklamatioun	R@klAmAsj@Un
reklaméiere	R@klAm3I@R@
reklaméieren	R@klAm3I@R@n
rekolt	R@kolt
remarque	R@mARk
remboursement	RA~:mbuRsm{nt
remorque	R@mORk
rendezvous	RA~:de:vu:
rëndfleesch	R@ntfle:S
reng	R{N
rénk	ReNk
renke	R{Nk@
renken	R{Nk@n
renndéier	R{nd3I6
renne	R{n@
rënne	R@n@
rennen	R{n@n
rënnen	R@n@n
renseignement	RA~:s{J@m{nt
rent	R{nt
rentabel	R{nta:b@l
reparatur	R@pARAtu:R
reporter	R@pORt6
rëpp	R@p
rescht	R{St
rëschte	R@St@
rëschten	R@St@n
rësel	R@z@l
rësele	R@z@l@
rëselen	R@z@l@n
reserve	RezERf
reservéiere	RezERv3I@R@
reservéieren	RezERv3I@R@n
respekt	R{sp{kt
respektiv	R{sp{kti:f
responsabel	R{spA~:sa:b@l
responsabele	R{spA~:sa:b@l@
responsabelen	R{spA~:sa:b@l@n
rëss	R@s
ressort	R@sO:R
restaurant	R{stoRA~:
resultat	R@zulta:t
retour	R@tu:R
rette	R{t@
retten	R{t@n
rettung	R{tuN
réunioun	Re:ynj@Un
revolver	R@volv6
revue	R@vy:
rezdechaussée	Re:tSo:se:
rezept	R@ts{pt
rhytmus	Ritmus
ribb	Rip
ribbe	Rib@
ribben	Rib@n
riche	Ris\@
richen	Ris\@n
richteg	Ris\t@s\
rido	Rido:
ried	Ri@t
riede	Ri@d@
riedele	Ri@d@l@
riedelen	Ri@d@l@n
rieden	Ri@d@n
riedner	Ri@dn6
rief	Ri@f
riets	Ri@ts
riicht	Ri:s\t
riichtaus	Ri:z\d{:Us
riichter	Ri:s\t6
riichteraus	Ri:z\d@R{:Us
riichtewech	Ri:z\d@v{s\
rill	Ril
rimm	Rim
ris	Ri:s
riseg	Ri:z@s\
risele	Riz@l@
riselen	Riz@l@n
riserad	Ri:z@Ra:t
riskéiere	Risk3I@R@
riskéieren	Risk3I@R@n
roboter	Robot6
rode	Ro:d@
roden	Ro:d@n
roff	Rof
roll	Rol
rollschong	RolSoN
rollstull	RolStul
rollued	Rollu@t
rolze	Rolts@
rolzen	Rolts@n
roman	Roma:n
romantesch	RomAnt@S
romarin	RomARE~:
rommel	Rom@l
rondel	Rond@l
ronderëm	Rond@R@m
ronke	RoNk@
ronken	RoNk@n
ronn	Ron
ronschel	RonS@l
ronschele	RonS@l@
ronschelen	RonS@l@n
rosa	Ro:za:
rose	Ro:z@
rosen	Ro:z@n
roserei	Roz@RAI
rot	Ro:t
rou	R@U
roudelzeg	R@Ud@lts@s\
roue	R@U@
roueg	R@U@s\
rouen	R@U@n
rouer	R@U6
roulad	Rula:t
roulade	Rula:d@
rouladen	Rula:d@n
roulotte	Rulot
rous	R@Us
rouscht	R@USt
rouse	R@Uz@
rousekranz	R@Uz@kRAnts
rousen	R@Uz@n
rout	R@Ut
routine	Rutin
rucksak	Rukza:k
rücksicht	Rykzis\t
rudder	Rud6
rudderboot	Rud6bo:t
ruddere	Rud@R@
rudderen	Rud@R@n
ruffe	Ruf@
ruffen	Ruf@n
rugby	Rygbi:
ruin	Ru:i:n
rull	Rul
rulle	Rul@
rullen	Rul@n
rumänesch	RumE:n@S
rumm	Rum
rüssel	Rys@l
russesch	Rus@S
rutschbahn	RutSba:n
rutsche	RutS@
rutschen	RutS@n
rutt	Rut
saach	za:X
saaft	za:ft
sabbelduch	zAb@lduX
sabbele	zAb@l@
sabbelen	zAb@l@n
sächlech	z{s\l@s\
sachlech	zAXl@s\
säfteg	z{ft@s\
saier	zAI6
säin	z{:In
saison	sE:zA~:
säit	z{:It
sak	za:k
sakgaass	za:kga:s
salef	za:l@f
sall	zAl
sällche	z{ls\@
sällchen	z{ls\@n
salon	sAlA~:
salz	zAlts
salzdëppche	zAltsd@ps\@
salzdëppchen	zAltsd@ps\@n
salze	zAlts@
salzeg	zAlts@s\
salzen	zAlts@n
sam	za:m
samett	za:m{t
sammele	zAm@l@
sammelen	zAm@l@n
samschdeg	zAmSd@s\
samschdes	zAmSd@s
sand	zAnt
sandal	zAnda:l
sandauer	zAndAU6
sandbuerg	zAntbu6s\
sandkëscht	zAntk@St
sandwich	s{ntwitS
sange	zAN@
sangen	zAN@n
sänger	z{N6
sängerin	z{N@Rin
sat	za:t
sau	z{:U
sauer	zAU6
sauerampel	zAU6Amp@l
sauerkraut	zAU6kRAUt
sauermous	zAU6m@Us
sauerstoff	zAU6Stof
saufe	z{:Uf@
saufen	z{:Uf@n
sauna	zAUna:
saz	za:ts
schaardeg	Sa:Rd@s\
schaarf	Sa:Rf
schaaschtech	Sa:St@s\
schach	SAX
schäerft	SE:6ft
schaf	Sa:f
schafe	Sa:f@
schafen	Sa:f@n
schäffche	S{fs\@
schäffchen	S{fs\@n
schaffdag	SAfda:X
schäffe	S{f@
schaffe	SAf@
schäffen	S{f@n
schaffen	SAf@n
schaffert	SAf6t
schaime	SAIm@
schaimen	SAIm@n
schäin	S{:In
schäissdreck	S{:IsdR{k
schäisse	S{:Is@
schäissen	S{:Is@n
schal	Sa:l
schale	Sa:l@
schalen	Sa:l@n
schallekseg	SAleks@s\
schalter	SAlt6
schampes	SAmp@s
schan	Sa:n
schank	SANk
schapp	SAp
schappe	SAp@
schappeg	SAp@s\
schappen	SAp@n
schatz	SAts
schätze	S{ts@
schätzen	S{ts@n
schätzung	S{tsuN
schauer	SAU6
schauere	SAU@R@
schaueren	SAU@R@n
schaukel	SAUk@l
schaukele	SAUk@l@
schaukelen	SAUk@l@n
schaukelpäerd	SAUk@lpE:6t
schaum	S{:Um
schaumläffel	S{:Uml{f@l
schauspiller	SAUSpil6
schauspillerin	SAUSpil@Rin
schausseg	S{:Us@s\
scheck	S{k
scheckbuch	S{kbuX
schécke	Sek@
schécken	Sek@n
schëdde	S@d@
schëdden	S@d@n
scheede	Se:d@
scheeden	Se:d@n
scheedung	Se:duN
schëff	S@f
schei	SAI
scheier	SAI6
schéier	S3I6
schéifer	S3If6
schéin	S3In
schéinheet	S3Inhe:t
scheinwerfer	SAInvERf6
schéissbud	S3Isbu:t
schéisse	S3Is@
schéissen	S3Is@n
schëld	S@lt
schell	S{l
schelle	S{l@
schellen	S{l@n
schëller	S@l6
schénge	SeN@
schéngen	SeN@n
schenke	S{Nk@
schenken	S{Nk@n
schëpp	S@p
schëppche	S@ps\@
schëppchen	S@ps\@n
schi	Si:
schibengel	Si:b{N@l
schick	Sik
schicksal	Sikza:l
schiedlech	Si@dl@s\
schiele	Si@l@
schielen	Si@l@n
schierbel	Si6b@l
schierbele	Si6b@l@
schierbelen	Si6b@l@n
schiertech	Si6t@s\
schiet	Si@t
schif	Si:f
schifer	Si:f6
schildkröt	SiltkR2:t
schimmeg	Sim@s\
schimmeleg	Sim@l@s\
schimt	Simt
schinn	Sin
schippelche	Sip@ls\@
schippelchen	Sip@ls\@n
schlaang	Sla:N
schlagsahn	Sla:Xsa:n
schläiche	Sl{:Is\@
schläichen	Sl{:Is\@n
schläife	Sl{:If@
schläifen	Sl{:If@n
schlaksert	SlAks6t
schlamm	SlAm
schlank	SlANk
schlapp	SlAp
schlass	SlAs
schlässer	Sl{s6
schlau	SlAU
schlauch	Sl{:UX
schlecht	Sl{s\t
schléck	Slek
schlécke	Slek@
schlécken	Slek@n
schleefe	Sle:f@
schleefen	Sle:f@n
schleek	Sle:k
schleekenhaische	Sle:k@nhAIsj@
schleekenhaischen	Sle:k@nhAIsj@n
schleidere	SlAId@R@
schleideren	SlAId@R@n
schleier	SlAI6
schléif	Sl3If
schléifer	Sl3If6
schleis	SlAIs
schléiwe	Sl3Iv@
schléiwen	Sl3Iv@n
schléiwenheck	Sl3Iv@nh{k
schlëmm	Sl@m
schlëssel	Sl@s@l
schlësselbee	Sl@s@lbe:
schlësselbeen	Sl@s@lbe:n
schlëssellach	Sl@s@llAX
schliisslech	Sli:sl@s\
schlips	Slips
schlitt	Slit
schlittschong	SlitSoN
schlitz	Slits
schloe	Slo:@
schloen	Slo:@n
schlof	Slo:f
schlofe	Slo:f@
schlofen	Slo:f@n
schloff	Slof
schlofkap	Slo:fka:p
schlofkummer	Slo:fkum6
schlofsak	Slo:fza:k
schlofzëmmer	Slo:fts@m6
schloper	Slo:p6
schloree	SloRe:
schloreen	SloRe:n
schluecht	Slu@s\t
schluechte	Slu@s\t@
schluechten	Slu@s\t@n
schluechthaus	Slu@s\th{:Us
schluet	Slu@t
schlupp	Slup
schluppe	Slup@
schluppen	Slup@n
schluss	Slus
schmaache	Sma:X@
schmaachen	Sma:X@n
schmalz	SmAlts
schmeier	SmAI6
schmëlze	Sm@lts@
schmëlzen	Sm@lts@n
schmier	Smi6
schmiere	Smi@R@
schmieren	Smi@R@n
schmotzeg	Smots@s\
schmuddeleg	Smud@l@s\
schmuel	Smu@l
schmuelef	Smu@l@f
schmull	Smul
schmunze	Smunts@
schmunzen	Smunts@n
schnaarche	Sna:Rs\@
schnaarchen	Sna:Rs\@n
schnäize	Sn{:Its@
schnäizen	Sn{:Its@n
schnape	Sna:p@
schnapen	Sna:p@n
schnapp	SnAp
schnaps	SnAps
schnatt	SnAt
schnauer	SnAU6
schnauz	Sn{:Uts
schneekeg	Sne:k@s\
schnéi	Sn3I
schnéibiesem	Sn3Ibi@z@m
schneide	SnAId@
schneiden	SnAId@n
schneider	SnAId6
schneie	SnAI@
schneien	SnAI@n
schnéiflack	Sn3IflAk
schnéiklatz	Sn3IklAts
schnéimännche	Sn3Im{ns\@
schnéimännchen	Sn3Im{ns\@n
schnéiwick	Sn3Ivik
schnell	Sn{l
schnëppel	Sn@p@l
schnëss	Sn@S
schnësse	Sn@s@
schnëssen	Sn@s@n
schnëtze	Sn@ts@
schnëtzen	Sn@ts@n
schniewel	Sni@v@l
schnitzel	Snits@l
schnoffele	Snof@l@
schnoffelen	Snof@l@n
schnouer	Sn@U6
schnuddel	Snud@l
schnuddelhong	Snud@lhoN
schnurres	SnuR@s
scho	So
schock	Sok
schockela	Sok@la:
schof	So:f
schokant	SokAnt
schold	Solt
schong	SoN
schonggréisst	SoNgR3Ist
schongläffel	SoNl{f@l
schongnummer	SoNnum6
schongstréckel	SoNStRek@l
schonn	Son
schossel	Sos@l
schoul	S@Ul
schoulmeeschter	S@Ulme:St6
schoulsak	S@Ulza:k
schoune	S@Un@
schounen	S@Un@n
schouschter	S@USt6
schräiner	SR{:In6
schratt	SRAt
schrauf	SRAUf
schraufstack	SRAUfStAk
schrauwe	SRAUv@
schrauwemudder	SRAUv@mud6
schrauwen	SRAUv@n
schrauwenzéier	SRAUv@nts3I6
schreck	SR{k
schrécke	SRek@
schrécken	SRek@n
schrecklech	SR{kl@s\
schrëft	SR@ft
schrëftlech	SR@ftl@s\
schrëftsteller	SR@ftSt{l6
schreifdësch	SRAIfd@S
schreifmaschinn	SRAIfmASin
schréips	SR3Ips
schréipse	SR3Ips@
schréipsen	SR3Ips@n
schreiwe	SRAIv@
schreiwen	SRAIv@n
schro	SRo:
schrott	SRot
schrubbe	SRub@
schrubben	SRub@n
schrubber	SRub6
schrumm	SRum
schubkar	Subka:R
schudder	Sud6
schuddere	Sud@R@
schudderen	Sud@R@n
schueberfouer	Su@b6f@U6
schued	Su@t
schuede	Su@d@
schueden	Su@d@n
schuel	Su@l
schüler	Sy:l6
schülerin	Sy:l@Rin
schumme	Sum@
schummen	Sum@n
schupp	Sup
schutzblech	Sutsbl{s\
schütze	Syts@
schützen	Syts@n
schwaach	Swa:X
schwaachheet	Swa:Xhe:t
schwaarz	Swa:Rts
schwäche	Sw{s\@
schwächen	Sw{s\@n
schwächt	Sw{s\t
schwäerme	SwE:6m@
schwäermen	SwE:6m@n
schwäin	Sw{:In
schwäistall	Sw{:IStAl
schwäiz	Sw{:Its
schwammbox	SwAmboks
schwamme	SwAm@
schwammen	SwAm@n
schwamp	SwAmp
schwan	Swa:n
schwanz	SwAnts
schwätze	Sw{ts@
schwätzen	Sw{ts@n
schwedesch	Swe:d@S
schweess	Swe:s
schweesse	Swe:s@
schweessen	Swe:s@n
schwéier	Sw3I6
schwéiereltere	Sw3I6{lt@R@
schwéierelteren	Sw3I6{lt@R@n
schwéierleit	Sw3I6lAIt
schwéiermamm	Sw3I6mAm
schwéierpapp	Sw3I6pAp
schwéiesch	Sw3I@S
schwëlle	Sw@l@
schwëllen	Sw@l@n
schwemm	Sw{m
schwëmmer	Sw@m6
schwéngefleesch	SweN@fle:S
schwéngerei	SweN@RAI
schwéngskotlett	SweNskotl{t
schwenke	Sw{Nk@
schwenken	Sw{Nk@n
schwëster	Sw@st6
schwier	Swi6
schwiere	Swi@R@
schwiereg	Swi:R@s\
schwieregkeet	Swi:R@s\ke:t
schwieren	Swi@R@n
schwiewe	Swi@v@
schwiewen	Swi@v@n
schwoer	Swo:6
schwonk	SwoNk
scout	skAUt
se	z@
sech	z@s\
séchel	z@s\@l
sécher	z@s\6
sécherheet	z@s\6he:t
sécherheetsglas	z@s\6he:tsgla:s
sécherheetsnetz	z@s\6he:tsn{ts
sécherheetsrimm	z@s\6he:tsRim
sechs	z{ks
sechste	z{kst@
sechsten	z{kst@n
sechzeg	z{s\ts@s\
séckche	zeks\@
séckchen	zeks\@n
see	ze:
seeche	ze:s\@
seechen	ze:s\@n
seechomes	ze:z\o:m@s
seeën	ze:@n
seef	ze:f
seefe	ze:f@
seefen	ze:f@n
seefepolver	ze:f@polf6
seel	ze:l
seeldänzer	ze:ld{nts6
seele	ze:l@
seelen	ze:l@n
seelsprange	ze:lSpRAN@
seelsprangen	ze:lSpRAN@n
seemiel	ze:mi@l
seen	ze:n
seene	ze:n@
seenen	ze:n@n
sëff	z@f
sëffer	z@f6
segel	ze:z\@l
segelboot	ze:z\@lbo:t
segele	ze:z\@l@
segelen	ze:z\@l@n
seguer	z@gu6
séi	z3I
seibecke	zAIb{k@
seibecken	zAIb{k@n
seid	zAIt
séie	z3I@
séien	z3I@n
séier	z3I6
séihond	z3Ihont
séikrank	z3IkRANk
séil	z3Il
séiss	z3Is
séiwaasser	z3Iva:s6
sekonn	z@kon
sekretär	s@kRetE:R
sekretariat	s@kRetARja:t
sekretärin	s@kRetE:Rin
sëllech	z@l@s\
selwer	z{lv6
sëlwer	z@lv6
sëndege	z@nd@z\@
sëndegen	z@nd@z\@n
seng	zeN
sënn	z@n
september	z{ptemb6
serie	seRi:
seriö	s{Rj2:
serveuse	sERv2:s
service	sERvis
servicer	sERvis6
sëtz	z@ts
setze	z{ts@
sëtze	z@ts@
setzen	z{ts@n
sëtzen	z@ts@n
sëtzung	z@tsuN
seufze	zoIfts@
seufzen	zoIfts@n
short	SORt
si	zi
si	zi:
siche	zis\@
sichen	zis\@n
sickere	zik@R@
sickeren	zik@R@n
siechzeg	zi@s\ts@s\
siechzéng	zi@s\tseN
sief	zi@f
siff	zif
siffe	zif@
siffen	zif@n
sinistréiert	sinistR3I6t
sinn	zin
sireen	siRe:n
sirup	siRup
siwe	zi:v@
siwen	zi:v@n
siwente	zi:v@nt@
siwenten	zi:v@nt@n
siweschléifer	zi:v@Sl3If6
siwwenzeg	ziv@nts@s\
siwwenzéng	ziv@ntseN
skizz	skits
soe	zo:@
soen	zo:@n
solde	sold@
solden	sold@n
solle	zol@
sollen	zol@n
som	zo:m
sonn	zon
sonndeg	zond@s\
sonndes	zond@s
sonneg	zon@s\
sonneprabbeli	zon@pRAb@li:
sonnestéch	zon@St@s\
soss	zos
sou	z@U
soubal	z@Uba:l
sougenannt	z@Ug@nAnt
souguer	z@Ugu6
soutien	sutjE~:
souvill	z@Ufil
souwisou	z@Uviz@U
spaass	Spa:s
spaasse	Spa:s@
spaasseg	Spa:s@s\
spaassen	Spa:s@n
spachtel	SpAXt@l
spackelter	SpAk@lt6
spadséiere	SpAdz3I@R@
spadséieren	SpAdz3I@R@n
spadséiergank	SpAdz3I6gANk
spaghetti	SpAg{ti:
späicher	Sp{:Is\6
späize	Sp{:Its@
späizen	Sp{:Its@n
spane	Spa:n@
spanen	Spa:n@n
spann	SpAn
spanne	SpAn@
spannen	SpAn@n
spannend	SpAn@nt
spannung	SpAnuN
späre	SpE:R@
spären	SpE:R@n
spargel	SpARz\@l
spatz	SpAts
spaut	Sp{:Ut
spaweck	Spa:v{k
specht	Sp{s\t
speck	Sp{k
speis	SpAIs
spéit	Sp3It
spéitstens	Sp3Itst@ns
spektiv	Sp{kti:f
spéngel	SpeN@l
spéngele	SpeN@l@
spéngelen	SpeN@l@n
spënnche	Sp@ns\@
spënnchen	Sp@ns\@n
spëtzbouf	Sp@tsb@Uf
spëtze	Sp@ts@
spëtzen	Sp@ts@n
spëtznumm	Sp@tsnum
spëtzt	Sp@tst
spezialist	Spe:tsjAlist
spezifesch	Spetsi:f@S
spidol	Spido:l
spiecht	Spi@s\t
spiere	Spi:R@
spieren	Spi:R@n
spigel	Spiz\@l
spigelee	Spiz\@le:
spill	Spil
spillbuttek	Spilbutek
spille	Spil@
spillen	Spil@n
spillplaz	Spilpla:ts
spillsaach	Spilza:X
spinat	Spina:t
spioun	Spj@Un
spläiter	Spl{:It6
spléck	Splek
splécke	Splek@
splécken	Splek@n
splitter	Split6
sport	SpORt
sportlech	SpORtl@s\
spottnumm	Spotnum
sprangbur	SpRANbu:R
sprange	SpRAN@
sprangen	SpRAN@n
sprangseel	SpRANze:l
sprechzëmmer	SpR{s\ts@m6
spréif	SpR3If
sprenz	SpR{nts
sprëtz	SpR@ts
sprëtze	SpR@ts@
sprëtzen	SpR@ts@n
sprinkler	SpRiNkl6
sprock	SpRok
spronk	SpRoNk
sprooch	SpRo:X
spruddele	SpRud@l@
spruddeleg	SpRud@l@s\
spruddelen	SpRud@l@n
spruddelwaasser	SpRud@lva:s6
sprutze	SpRuts@
sprutzen	SpRuts@n
spuenesch	Spu@n@S
spuenie	Spu@ni@
spuenien	Spu@ni@n
spuerbéchs	Spu6beks
spuere	Spu@R@
spueren	Spu@R@n
spuerkeess	Spu6ke:s
spuervull	Spu6ful
spuet	Spu@t
spull	Spul
spulle	Spul@
spullen	Spul@n
spullmaschinn	SpulmASin
spullomp	Spullomp
spullstee	SpulStee
spullsteen	SpulSteen
spur	Spu:R
sputt	Sput
staang	Sta:N
staark	Sta:Rk
staatsrot	Sta:tsRo:t
stäbercher	StE:b6s\6
stabill	StAbil
stachel	StAX@l
stack	StAk
stackfësch	StAkf@S
stad	Sta:t
stage	sta:S
stäil	St{:Il
stäip	St{:Ip
stäipe	St{:Ip@
stäipen	St{:Ip@n
stall	StAl
stallhale	StAlha:l@
stallhalen	StAlha:l@n
stamm	StAm
standard	stA~:nda:R
stär	StE:R
starte	Sta:Rt@
starten	Sta:Rt@n
starter	Sta:Rt6
stat	Sta:t
statu	Sta:tu:
stau	StAU
staubsauger	St{:UbzAUg6
staumauer	StAUmAU6
staune	StAUn@
staunen	StAUn@n
stauséi	StAUz3I
staut	St{:Ut
stëbs	St@ps
stëbse	St@ps@
stëbsen	St@ps@n
stëbsfatz	St@psfAts
stëbslomp	St@pslomp
stéck	Stek
steckdous	St{kd@Us
stecker	St{k6
stéckseg	Steks@s\
stee	Ste:
steekaul	Ste:kAUl
steemetzer	Ste:m{ts6
steen	Ste:n
steier	StAI6
stéier	St3I6
stéiere	St3I@R@
stéieren	St3I@R@n
steif	StAIf
stéifkand	St3IfkAnt
stéifmamm	St3IfmAm
stéifpapp	St3IfpAp
steiwe	StAIv@
steiwen	StAIv@n
stëll	St@l
stelle	St{l@
stellen	St{l@n
stelz	St{lts
stëmm	St@m
stëmme	St@m@
stëmmen	St@m@n
stëmmung	St@muN
stempel	St{mp@l
stempele	St{mp@l@
stempelen	St{mp@l@n
stenge	St{N@
stengen	St{N@n
sténke	SteNk@
sténken	SteNk@n
stënterlech	St@nt6l@s\
stëppche	St@ps\@
stëppchen	St@ps\@n
steppe	St{p@
stëppele	St@p@l@
stëppelen	St@p@l@n
steppen	St{p@n
steriliséiere	SteRiliz3I@R@
steriliséieren	SteRiliz3I@R@n
stiedche	Sti@ts\@
stiedchen	Sti@ts\@n
stiele	Sti@l@
stielen	Sti@l@n
stierme	Sti6m@
stiermen	Sti6m@n
stierwe	Sti6v@
stierwen	Sti6v@n
stierze	Sti6ts@
stierzen	Sti6ts@n
stiichte	Sti:s\t@
stiichten	Sti:s\t@n
still	Stil
stitzche	Stitsj@
stitzchen	Stitsj@n
stiwwel	Stiv@l
stodéiere	Stod3I@R@
stodéieren	Stod3I@R@n
stodent	Stod{nt
stoe	Sto:@
stoen	Sto:@n
stoff	Stof
stol	Sto:l
stolpere	Stolp@R@
stolperen	Stolp@R@n
stomm	Stom
stompeg	Stomp@s\
stonn	Ston
stonnelaang	Ston@la:N
stop	Stop
stopp	Stop
stoppe	Stop@
stoppen	Stop@n
stoppenzéier	Stop@nts3I6
stopschëld	StopS@lt
storch	StORs\
store	stO:R
stot	Sto:t
stousse	St@Us@
stoussen	St@Us@n
sträiche	StR{:Is\@
sträichen	StR{:Is\@n
sträif	StR{:If
sträit	StR{:It
stral	StRa:l
strapp	StRAp
strass	StRAs
strauch	StR{:UX
strauss	StR{:Us
stréch	StR@s\
streckbriet	StR{kbRi@t
strecke	StR{k@
strécke	StRek@
stréckel	StRek@l
strecken	StR{k@n
strécken	StRek@n
stréckleeder	StRekle:d6
streech	StRe:s\
streeën	StRe@n
stréi	StR3I
stréiballe	StR3IbAl@
stréiballen	StR3IbAl@n
streide	StRAId@
streiden	StRAId@n
streidereg	StRAId@R@s\
stréihutt	StR3Ihut
streik	StRAIk
stréile	StR3Il@
stréilen	StR3Il@n
strëmp	StR@mp
streng	StR{N
strenz	StR{nts
strof	StRo:f
strofe	StRo:f@
strofen	StRo:f@n
strooss	StRo:s
stroossekaart	StRo:s@ka:Rt
stroosseluucht	StRo:s@lu:Xt
stroosseschëld	StRo:s@S@lt
stroum	StR@Um
strummert	StRum6t
stuckele	Stuk@l@
stuckelen	Stuk@l@n
studéiere	Stud3I@R@
studéieren	Stud3I@R@n
student	Stud{nt
stuerke	Stu6k@
stuerken	Stu6k@n
stuerm	Stu6m
stuff	Stuf
stull	Stul
stulldreiwend	StuldRAIv@nt
stur	Stu:R
stylo	stilo:
suckel	zuk@l
suckele	zuk@l@
suckelen	zuk@l@n
süde	zy:d@
süden	zy:d@n
sue	zu:@
suedel	zu@d@l
suel	zu@l
suen	zu@n
suerg	zu6s\
suerge	zu6z\@
suergen	zu6z\@n
suggeréiere	sygZeR3I@R@
suggeréieren	sygZeR3I@R@n
sujet	syZe:
sujete	syZe:@
summer	zum6
summerwee	zum6we:
super	zup6
supp	zup
suppeg	zup@s\
suppel	sup@l
surfe	s9:Rf@
surfen	s9:Rf@n
surveillant	syRvE:jA~:
sympathesch	simpa:t@S
taart	ta:Rt
taaschte	ta:St@
taaschten	ta:St@n
tabell	tAb{l
tableau	tAblo:
tablette	tAbl{t
tabouret	tAbuRe:
tachtele	tAXt@l@
tachtelen	tAXt@l@n
tafel	ta:f@l
taille	tAIl
talent	tAl@nt
tallek	tAlek
tank	tANk
tanke	tANk@
tanken	tANk@n
tankwon	tANkvo:n
tapéit	tAp3It
tarnung	tARnuN
tas	ta:s
täsch	t{S
täscheluucht	t{S@lu:Xt
täschemesser	t{S@m{s6
tässele	t{s@l@
tässelen	t{s@l@n
tatsächlech	ta:tz{s\l@s\
tatta	tAta:
tatz	tAts
taucher	t{:UX6
tausche	t{:US@
tauschen	t{:US@n
taxi	tAksi:
techniker	t{s\nik6
técke	tek@
técken	tek@n
teenager	ti:n3IdZ6
téi	t3I
téitsch	t3ItS
tëlee	t@le:
telefon	t@l@fon
telefonéiere	t@l@fon3I@R@
telefonéieren	t@l@fon3I@R@n
telefonsbuch	t@l@fonsbuX
telefonsnummer	t@l@fonsnum6
telegramm	t@l@gRAm
teleskop	tel{sko:p
televisioun	t@l@vizj@Un
teller	t{l6
tellerche	t{l6s\@
tellerchen	t{l6s\@n
tëmpche	t@mps\@
tëmpchen	t@mps\@n
temperatur	t{mp@RAtu:R
tendenz	t{nd{nts
tennis	t{nis
tënt	t@nt
teppech	t{p@s\
termäin	tERm{:In
terrain	t{RE~:
terrass	t{RAs
tëschent	t@S@nt
tëschewand	t@S@vAnt
text	t{kst
theater	tea:t6
thermometer	tERmome:t6
thon	tA~:
thüringer	tyRiN6
ticket	tike:
ticketsautomat	tike:zAUtoma:t
tierkele	ti6k@l@
tierkelen	ti6k@l@n
tiger	ti:g6
timber	tE~:mb6
tipp	tip
tippe	tip@
tippen	tip@n
tiptop	tiptop
tirang	tiRAN
tirebouchon	ti6buSA~:
titel	tit@l
toast	toUst
toaster	toUst6
tobe	to:b@
toben	to:b@n
toilette	twAl{t
toilettepabeier	twAl{t@pAbAI6
toleréiere	tol@R3I@R@
toleréieren	tol@R3I@R@n
tomat	toma:t
tomatejus	toma:t@jy:
tommel	tom@l
tommele	tom@l@
tommelen	tom@l@n
tompe	tomp@
tompen	tomp@n
topeg	to:p@s\
topert	to:p6t
torschong	tORSoN
tosch	toS
toun	t@Un
tour	tu:R
tourist	tuRist
tous	tus
toz	to:ts
toze	to:ts@
tozen	to:ts@n
traditionell	tRAditjon{l
training	tRE:niN
träip	tR{:Ip
träipe	tR{:Ip@
träipen	tR{:Ip@n
trakter	tRAkt6
tram	tRAm
trampele	tRAmp@l@
trampelen	tRAmp@l@n
träntele	tR{nt@l@
träntelen	tR{nt@l@n
trap	tRa:p
trapez	tRApe:ts
trapp	tRAp
tratt	tRAt
traue	tRAU@
trauen	tRAU@n
trauer	tRAU6
trauerweid	tRAU6vAIt
traufel	tR{:Uf@l
traureg	tRAUR@s\
trausch	tR{:US
treffe	tR{f@
treffen	tR{f@n
trei	tRAI
treiheet	tRAIhe:t
tréin	tR3In
tréischte	tR3ISt@
tréischten	tR3ISt@n
trëlle	tR@l@
trëllen	tR@l@n
trëndel	tR@nd@l
trenne	tR{n@
trennen	tR{n@n
trennung	tR{nuN
trëppele	tR@p@l@
trëppelen	tR@p@l@n
trepplek	tR{plek
trëttbriet	tR@tbRi@t
trëtz	tR@ts
trëtze	tR@ts@
trëtzen	tR@ts@n
trick	tRik
triichter	tRi:s\t6
tripsen	tRips@n
triwwele	tRiv@l@
triwwelen	tRiv@l@n
tromm	tRom
trommelfell	tRom@lf{l
trompett	tRomp{t
troter	tRo:t6
trottinette	tRotin{t
trottoir	tRotwa:R
trottoiren	tRotwa:R@n
trotz	tRots
trotzdem	tRotsde:m
trotze	tRots@
trotzeg	tRots@s\
trotzen	tRots@n
troun	tR@Un
trouscht	tR@USt
truh	tRu:
trupp	tRup
tsunami	tsuna:mi:
tubak	tuba:k
tuddele	tud@l@
tuddelen	tud@l@n
tuerm	tu6m
tulp	tulp
tunnel	tun{l
tuppi	tupi:
turbot	tyRbo:
turne	tuRn@
turnen	tuRn@n
turner	tuRn6
turnschlapp	tuRnSlAp
tuschbic	tuSbik
tut	tu:t
tute	tu:t@
tuten	tu:t@n
typ	tip
ubanne	ubAn@
ubannen	ubAn@n
übe	y:b@
üben	y:b@n
ubezuele	ub@tsu@l@
ubezuelen	ub@tsu@l@n
ubidde	ubid@
ubidden	ubid@n
ubiede	ubi@d@
ubieden	ubi@d@n
uboot	u:bo:t
übung	y:buN
uebst	u@bst
uebstpress	u@bstpR{s
uechter	u@s\t6
uechzeg	u@s\ts@s\
uechzéng	u@s\tseN
uelech	u@l@s\
uerdentlech	u6d@ntl@s\
uerdnung	u6dnuN
uerg	u6s\
uerteel	u6te:l
uertschaft	u6tSAft
uess	u@s
ueter	u@t6
uewe	u@v@
uewen	u@v@n
uewenop	u@v@nop
ufänger	uf{N6
ufank	ufANk
ufänke	uf{Nk@
ufänken	uf{Nk@n
ufer	u:f6
ufuere	ufu@R@
ufueren	ufu@R@n
ugeklote	ug@klo:t@
ugekloten	ug@klo:t@n
ugesi	ug@zi
ugesinn	ug@zin
ugi	ugi
uginn	ugin
uglotze	uglots@
uglotzen	uglots@n
ugoe	ugo:@
ugoen	ugo:@n
ugräife	ugR{:If@
ugräifen	ugR{:If@n
ugrëff	ugR@f
ugrëffeg	ugR@f@s\
ugrëffer	ugR@f6
ukënnege	uk@n@z\@
ukënnegen	uk@n@z\@n
uklo	uklo:
ukloe	uklo:@
ukloen	uklo:@n
ukomme	ukom@
ukommen	ukom@n
ukräize	ukR{:Its@
ukräizen	ukR{:Its@n
ulackele	ulAk@l@
ulackelen	ulAk@l@n
uleeën	ule:@n
ulm	ulm
um	um
umeldung	um{lduN
umelle	um{l@
umellen	um{l@n
umoosse	umo:s@
umoossen	umo:s@n
undoe	undo:@
undoen	undo:@n
undrécke	undRek@
undrécken	undRek@n
unerkenne	un6k{n@
unerkennen	un6k{n@n
unhale	unha:l@
unhalen	unha:l@n
unhaltspunkt	unhAltspuNkt
unhänger	unh{N6
unhänglech	unh{Nl@s\
unhänglechkeet	unh{Nl@s\ke:t
unhänke	unh{Nk@
unhänken	unh{Nk@n
unhu	unhu
unhuele	unhu@l@
unhuelen	unhu@l@n
unhunn	unhun
uniform	unifORm
upake	upa:k@
upaken	upa:k@n
upasse	upAs@
upassen	upAs@n
upassung	upAsuN
uplanze	uplAnts@
uplanzen	uplAnts@n
ureege	uRe:z\@
ureegen	uRe:z\@n
uriede	uRi@d@
urieden	uRi@d@n
urmënsch	u:Rm@nS
ursaach	u:Rza:X
ursprénglech	u:RSpReNl@s\
uruffe	uRuf@
uruffen	uRuf@n
uschäin	uS{:In
uschäisse	uS{:Is@
uschäissen	uS{:Is@n
uschmiere	uSmi6@
uschmieren	uSmi6@n
usoe	uzo:@
usoen	uzo:@n
ustieche	uSti@s\@
ustiechen	uSti@s\@n
ustiechend	uSti@s\@nt
ustiwwele	uStiv@l@
ustiwwelen	uStiv@l@n
ustrach	uStRAX
usträiche	uStR{:Is\@
usträichen	uStR{:Is\@n
usträicher	uStR{:Is\6
ustrécke	uStRek@
ustrécken	uStRek@n
ustrengung	uStR{NuN
uvertraue	uf6tRAU@
uvertrauen	uf6tRAU@n
uweise	uvAIz@
uweisen	uvAIz@n
uweisung	uvAIzuN
uze	u:ts@
uzen	u:ts@n
vag	va:k
vakanz	vAkAnts
vas	va:s
vasen	va:z@n
vee	ve:
veen	ve:n
véi	f3I
véier	f3I6
véiereck	f3I6{k
véiereckeg	f3I6{k@s\
véierel	f3I@R@l
véierelsstonn	f3I@R@lsSton
véierte	f3I6t@
véierten	f3I6t@n
véierzeg	f3I6ts@s\
véierzéng	f3I6tseN
vëlleche	f@l@s\@
vëllechen	f@l@s\@n
vëlleg	f@l@s\
vëlo	v@lo:
vëlosartist	v@lo:zARtist
vëlosfuerer	v@lo:sfu@R6
vëlossport	v@lo:sSpORt
vendeur	vA~:nd9:R
vendeuse	vA~:nd2:s
ventouse	vA~:tu:s
veräin	f@R{:In
verännere	f6{n@R@
veränneren	f6{n@R@n
verännerung	f6{n@RuN
veräschtelung	f6{St@luN
verb	vERp
verband	f6bAnt
verbanne	f6bAn@
verbannen	f6bAn@n
verbattert	f6bAt6t
verbéie	f6b3I@
verbéien	f6b3I@n
verbessere	f6b{s@R@
verbesseren	f6b{s@R@n
verbëtze	f6b@ts@
verbëtzen	f6b@ts@n
verbidde	f6bid@
verbidden	f6bid@n
verbindung	f6binduN
verblatze	f6blAts@
verblatzen	f6blAts@n
verbléie	f6bl3I@
verbléien	f6bl3I@n
verblenne	f6bl{n@
verblennen	f6bl{n@n
verblöde	f6bl2:d@
verblöden	f6bl2:d@n
verbrauch	f6bR{:UX
verbrauche	f6bR{:UX@
verbrauchen	f6bR{:UX@n
verbraucher	f6bR{:UX6
verbraucht	f6bR{:UXt
verbreede	f6bRe:d@
verbreeden	f6bRe:d@n
verbrénge	f6bReN@
verbréngen	f6bReN@n
verbrenne	f6bR{n@
verbrennen	f6bR{n@n
verbrieche	f6bRi@s\@
verbriechen	f6bRi@s\@n
verbriecher	f6bRi@s\6
verbuede	f6bu@d@
verbueden	f6bu@d@n
verdacht	f6dAXt
verdächteg	f6d{s\t@s\
verdächtege	f6d{s\t@z\@
verdächtegen	f6d{s\t@z\@n
verdaddert	f6dAd6t
verdame	f6da:m@
verdamen	f6da:m@n
verdaue	f6dAU@
verdauen	f6dAU@n
verdauung	f6dAUuN
verdeedege	f6de:d@z\@
verdeedegen	f6de:d@z\@n
verdeele	f6de:l@
verdeelen	f6de:l@n
verdénge	f6deN@
verdéngen	f6deN@n
verdéngscht	f6deNSt
verdënne	f6d@n@
verdënnen	f6d@n@n
verdillege	f6dil@z\@
verdillegen	f6dil@z\@n
verdonste	f6donst@
verdonsten	f6donst@n
verdreckst	f6dR{kst
verdréie	f6dR3I@
verdréien	f6dR3I@n
verdreiwe	f6dRAIv@
verdreiwen	f6dRAIv@n
verdroe	f6dRo:@
verdroen	f6dRo:@n
verdross	f6dRos
verduebele	f6du@b@l@
verduebelen	f6du@b@l@n
verdutzt	f6dutst
vereelzt	f6e:lst
vereenegt	f@Re:n@s\t
veréiere	f@R3I@R@
veréieren	f@R3I@R@n
vereinfache	f@RAInfAX@
vereinfachen	f@RAInfAX@n
verfaule	f6fAUl@
verfaulen	f6fAUl@n
verfeele	f6fe:l@
verfeelen	f6fe:l@n
verféiere	f6f3I@R@
verféieren	f6f3I@R@n
verflucht	f6fluXt
verfollege	f6fol@z\@
verfollegen	f6fol@z\@n
verfroosse	f6fRo:s@
verfroossen	f6fRo:s@n
vergaangenheet	f6ga:N@nhe:t
vergewaltege	f6g@vAlt@z\@
vergewaltegen	f6g@vAlt@z\@n
vergiesse	f6gi@s@
vergiessen	f6gi@s@n
vergläiche	f6gl{:Is\@
vergläichen	f6gl{:Is\@n
vergréissere	f6gR3Is@R@
vergréisseren	f6gR3Is@R@n
verhale	f6ha:l@
verhalen	f6ha:l@n
verhalt	f6hAlt
verhandele	f6hAnd@l@
verhandelen	f6hAnd@l@n
verheemleche	f6he:ml@s\@
verheemlechen	f6he:ml@s\@n
verhéiere	f6h3I@R@
verhéieren	f6h3I@R@n
verhënnere	f6h@n@R@
verhënneren	f6h@n@R@n
verhonze	f6honts@
verhonzen	f6honts@n
verkafe	f6ka:f@
verkafen	f6ka:f@n
verkeefer	f6ke:f6
verkeeferin	f6ke:f@Rin
verkéier	f6k3I6
verkéiersluucht	f6k3I6slu:Xt
verkéiert	f6k3I6t
verklappe	f6klAp@
verklappen	f6klAp@n
verkleede	f6kle:d@
verkleeden	f6kle:d@n
verkniwwelt	f6kniv@lt
verkrauche	f6kR{:UX@
verkrauchen	f6kR{:UX@n
verkrëppelt	f6kR@p@lt
verkuebele	f6ku@b@l@
verkuebelen	f6ku@b@l@n
verlaange	f6la:N@
verlaangen	f6la:N@n
verlaangere	f6la:N@R@
verlaangeren	f6la:N@R@n
verlängere	f6l{N@R@
verlängeren	f6l{N@R@n
verléiere	f6l3I@R@
verléieren	f6l3I@R@n
verléift	f6l3Ift
verletze	f6l{ts@
verletzen	f6l{ts@n
verletzung	f6l{tsuN
verlobe	f6lo:b@
verloben	f6lo:b@n
verlobung	f6lo:buN
verloosse	f6lo:s@
verloossen	f6lo:s@n
verloscht	f6loSt
verloune	f6l@Un@
verlounen	f6l@Un@n
verluge	f6luR@
verlugen	f6luR@n
vermaache	f6ma:X@
vermaachen	f6ma:X@n
vermësche	f6m@S@
vermëschen	f6m@S@n
vermuersche	f6mu@RS@
vermuerschen	f6mu@RS@n
vermuuschte	f6mu:St@
vermuuschten	f6mu:St@n
vernenne	f6n{n@
vernennen	f6n{n@n
vernis	vERni:
vernoléissege	f6no:l3Is@z\@
vernoléissegen	f6no:l3Is@z\@n
verongléckte	f@Ronglekt@
verongléckten	f@Ronglekt@n
verpackung	f6pAkuN
verpake	f6pa:k@
verpaken	f6pa:k@n
verpasse	f6pAs@
verpassen	f6pAs@n
verpolfere	f6polf@R@
verpolferen	f6polf@R@n
verréckt	f6Rekt
verréider	f6R3Id6
verrode	f@Ro:d@
verroden	f@Ro:d@n
verrot	f6Ro:t
vers	vERs
versammele	f6zAm@l@
versammelen	f6zAm@l@n
versammlung	f6zAmluN
versaue	f6zAU@
versauen	f6zAU@n
verschafe	f6Sa:f@
verschafen	f6Sa:f@n
verschampeléiere	f6SAmp@l3I@R@
verschampeléieren	f6SAmp@l3I@R@n
verschidde	f6Sid@
verschidden	f6Sid@n
verschimmele	f6Sim@l@
verschimmelen	f6Sim@l@n
verschlass	f6SlAs
verschlechtere	f6Sl{s\t@R@
verschlechteren	f6Sl{s\t@R@n
verschlëmmere	f6Sl@m@R@
verschlëmmeren	f6Sl@m@R@n
verschmotze	f6Smotz@
verschmotzen	f6Smotz@n
verschotert	f6So:t6t
verschreiwe	f6SRAIv@
verschreiwen	f6SRAIv@n
verschwanne	f6SwAn@
verschwannen	f6SwAn@n
verschweesst	f6Swe:st
verschwendung	f6Sw{nduN
verschwomme	f6Swom@
verschwommen	f6Swom@n
verséchere	f6z@s\@R@
versécheren	f6z@s\@R@n
versécherung	f6z@s\@RuN
versécherungsspéngel	f6z@s\@RuNsSpeN@l
versenge	f6z{N@
versengen	f6z{N@n
versiche	f6zis\@
versichen	f6zis\@n
versoe	f6zo:@
versoen	f6zo:@n
verspéide	f6Sp3Id@
verspéiden	f6Sp3Id@n
verspéidung	f6Sp3IduN
versprieche	f6SpRi@s\@
verspriechen	f6SpRi@s\@n
verstäerke	f6StE:6k@
verstäerken	f6StE:6k@n
verstäerkung	f6StE:6kuN
verstand	f6StAnt
verstänneg	f6St{n@s\
verstännegkeet	f6St{n@s\ke:t
verstauche	f6St{:UX@
verstauchen	f6St{:UX@n
verstauchung	f6St{:UXuN
verstéiert	f6St3I6t
verstoe	f6Sto:@
verstoen	f6Sto:@n
verstoppe	f6Stop@
verstoppen	f6Stop@n
verstouss	f6St@Us
verstreeën	f6StRe@n
versuchskanéngche	f6zuXskAneNs\@
versuchskanéngchen	f6zuXskAneNs\@n
versuchung	f6zu:XuN
versuerge	f6zu6z\@
versuergen	f6zu6z\@n
vertausche	f6t{:US@
vertauschen	f6t{:US@n
vertraue	f6tRAU@
vertrauen	f6tRAU@n
vertrieder	f6tRi@d6
veruechtung	f6u@s\tuN
veruerteele	f6u6te:l@
veruerteelen	f6u6te:l@n
verwallt	f6vAlt
verwalte	f6vAlt@
verwalten	f6vAlt@n
verwandele	f6vAnd@l@
verwandelen	f6vAnd@l@n
verwéckele	f6vek@l@
verwéckelen	f6vek@l@n
verweigere	f6vAIz\@R@
verweigeren	f6vAIz\@R@n
verwieleche	f6vi@l@s\@
verwielechen	f6vi@l@s\@n
verwiessele	f6vi@s@l@
verwiesselen	f6vi@s@l@n
verwiesslung	f6vi@sluN
verwinne	f6vin@
verwinnen	f6vin@n
verwonnere	f6von@R@
verwonneren	f6von@R@n
verwurrele	f6vuR@l@
verwurrelen	f6vuR@l@n
verzeie	f6tsAI@
verzeien	f6tsAI@n
verzichte	f6tsis\t@
verzichten	f6tsis\t@n
verziele	f6tsi@l@
verzielen	f6tsi@l@n
verziere	f6tsi@R@
verzieren	f6tsi@R@n
verzolle	f6tsol@
verzollen	f6tsol@n
verzweiflung	f6tswAIfluN
verzweiwele	f6tswAIv@l@
verzweiwelen	f6tswAIv@l@n
vestiaire	v{stjE:R
veterinär	v@t@RinE:R
veterinären	ve:t@RinE:R@n
veterinärin	v@t@RinE:Rin
vexéiere	v{ks3I@R@
vexéieren	v{ks3I@R@n
vidange	vidA~:S
videoscassette	vide:o:skAs{t
viischt	fi:St
vijenzeg	fiz\@nts@s\
vill	fil
villa	vila:
villche	fils\@
villchen	fils\@n
villsäiteg	filz{:It@s\
vinaigrette	vinE:gR{t
violett	viol{t
virausgesi	fi:R{:Usg@zi
virausgesinn	fi:R{:Usg@zin
viraussoe	fi:R{:Uszo:@
viraussoen	fi:R{:Uszo:@n
virbereede	fi6b@Re:d@
virbereeden	fi6b@Re:d@n
virbereedung	fi6b@Re:duN
virdeel	fi6de:l
virdrun	fi6dRun
virfuere	fi6fu@R@
virfueren	fi6fu@R@n
virgäertche	fi6gE:6ts\@
virgäertchen	fi6gE:6ts\@n
virgänger	fi6g{N6
virgëschter	fi6g@St6
virgesi	fi6g@zi
virgesinn	fi6g@zin
virgoe	fi6go:@
virgoen	fi6go:@n
virgräife	fi6gR{:If@
virgräifen	fi6gR{:If@n
virléift	fi6l3Ift
virnumm	fi6num
virschlag	fi6Sla:X
virschloe	fi6Slo:@
virschloen	fi6Slo:@n
virsichteg	fi6zis\t@s\
virsprong	fi6SpRoN
virstelle	fi6St{l@
virstellen	fi6St{l@n
virstellung	fi6St{luN
virufuere	fi:Rufu@R@
virufueren	fi:Rufu@R@n
virugoe	fi:Rugo:@
virugoen	fi:Rugo:@n
virun	fi:Run
virundreiwe	fi:RundRAIv@
virundreiwen	fi:RundRAIv@n
virwäsch	fi6v{S
virwerfe	fi6vERf@
virwerfen	fi6vERf@n
virwetz	fi6v@ts
virwetzeg	fi6v@ts@s\
virwetztut	fi6v@tstu:t
virworf	fi6vORf
visàvis	viza:vi:
visitekaart	vizit@ka:Rt
vitrin	vitRin
viz	fi:ts
vläicht	fl{:Is\t
voila	vwAla:
vokal	voka:l
voll	fol
vollek	folek
vollekszielung	folekstsi@luN
vollert	fol6t
vollkommenheet	folkom@nhe:t
vrun	fRun
vu	fu
vue	vy:
vuë	vy:@
vuen	vy:@n
vugel	fuR@l
vulgär	vylgE:R
vulkan	vulka:n
vulkane	vulka:n@
vulkanescher	vulka:n@S6
vulkanescht	vulka:n@St
vull	ful
vullekiischt	ful@ki:St
vullenhaische	ful@nhAIsj@
vullenhaischen	ful@nhAIsj@n
vulleschäich	ful@S{:Is\
vum	fum
vun	fun
wa	vA
waache	va:s\@
waachen	va:s\@n
waakreg	va:kR@s\
waarde	va:Rd@
waarden	va:Rd@n
waarm	va:Rm
waarzel	va:Rts@l
waasser	va:s6
waasserfaarwe	va:s6fa:Rv@
waasserfaarwen	va:s6fa:Rv@n
waasserfall	va:s6fAl
waasserpouke	va:s6p@Uk@
waasserpouken	va:s6p@Uk@n
waasserschi	va:s6Si:
waasserstee	va:s6Ste:
waassersteen	va:s6Ste:n
waassertuerm	va:s6tu6m
wackele	vAk@l@
wackelegem	vAk@l@z\@m
wackelegen	vAk@l@z\@n
wackeleger	vAk@l@z\6
wackelen	vAk@l@n
wäermt	vE:6mt
wäertes	vE:6t@s
waff	vAf
wagon	vAgA~:
wahlbureaue	va:lbyRo:@
wahlbureauen	va:lbyRo:@n
wahrscheinlech	va:RSAInl@s\
währungsuniounen	vE:RuNsunj@Un@n
wäikeller	v{:Ik{l6
wäin	v{:In
wäisheetszant	v{:Ishe:tstsAnt
wäiss	v{:Is
wäisslech	v{:Isl@s\
wäit	v{:It
wäitsichteg	v{:Itsis\t@s\
wak	va:k
wakelter	va:k@lt6
wakeregem	va:k@R@z\@m
walbureaue	va:lbyRo:@
walbureauen	va:lbyRo:@n
walbüroen	va:lbyRo:@n
wale	va:l@
walen	va:l@n
walfësch	va:lf@S
walkampf	va:lkAmpf
wallis	vAlis
walross	va:lRos
walz	vAlts
walziedele	va:ltsi@d@l@
walziedelen	va:ltsi@d@l@n
wand	vAnt
wanders	vAnd6s
wandert	vAnd6t
wandlunge	vAndluN@
wandlungen	vAndluN@n
wandmille	vAntmil@
wandmillen	vAntmil@n
wandschaf	vAntSa:f
wandstouss	vAntSt@Us
wann	vAn
wanne	vAn@
wannen	vAn@n
wanter	vAnt6
wanterpneu	vAnt6pn2:
wantersport	vAnt6SpORt
war	va:6
war	va:R
waren	va:R@n
warndräieck	vARndR{:Iek
warne	vARn@
warnen	vARn@n
warnung	vARnuN
warscheinlech	va:RSAInl@s\
wartesall	vARt@zAl
wärungsuniounen	vE:RuNsunj@Un@n
wäsch	v{S
wäschanlag	v{SAnla:X
wäschanlage	v{SAnla:R@
waschanlage	vASAnla:R@
wäschbier	v{Sbi6
wäsche	v{S@
wäschen	v{S@n
wäscherei	v{S6AI
wäschkiche	v{Skis\@
wäschkichen	v{Skis\@n
wäschmaschinn	v{SmASin
wäschpolver	v{Spolf6
wasserdicht	vAs6dis\t
wasserleitung	vAs6lAItuN
wat	va:t
watt	vAt
wecker	v{k6
wee	ve:
weeche	ve:s\@
weechen	ve:s\@n
weed	ve:t
weekend	wi:k{nt
weekendhaischen	wi:k{nthAIsj@n
weekendhaisercher	wi:k{nthAIz6s\6
weenchen	ve:ns\@n
weenercher	we:n6s\6
weesekand	ve:z@kAnt
weess	ve:s
wéi	v3I
weibche	vAIps\@
weibchen	vAIps\@n
weiblech	vAIbl@s\
weid	vAIt
weide	vAId@
wéidéings	v3Id3INs
wéidéingt	v3Id3INt
weiden	vAId@n
weiderentwécklung	vAId6@ntvekluN
weiderfuere	vAId6fu@R@
weiderfueren	vAId6fu@R@n
weidergoe	vAId6go:@
weidergoen	vAId6go:@n
weie	vAI@
wéie	v3I@
weien	vAI@n
wéien	v3I@n
weier	vAI6
wéimere	v3Im@R@
wéimeren	v3Im@R@n
wéineg	v3In@s\
wéineger	v3In@z\6
wéini	v3Ini:
wéinst	v3Inst
wéinstens	v3Inst@ns
weis	vAIs
weise	vAIz@
weisen	vAIz@n
weit	vAIt
wëld	v@lt
well	v{l
wëll	v@l
wëlle	v@l@
wëllen	v@l@n
welt	v{lt
weltall	v{ldAl
weltmeeschterinne	v{ltme:St@Rin@
weltmeeschterinnen	v{ltme:St@Rin@n
weltmier	v{ltmi6
weltmierer	v{ltmi:R6
weltrekord	v{ltR@kORt
weltrekorder	v{ltR@kORd6
weltwonner	v{ltvon6
wëmper	v@mp6
wëndel	v@nd@l
wéngert	veN6t
wénke	veNk@
wénkel	veNk@l
wénken	veNk@n
wenne	v{n@
wennen	v{n@n
wënsche	v@nS@
wënschen	v@nS@n
werfe	vERf@
werfen	vERf@n
wesentlech	ve:z@ntl@s\
wësse	v@s@
wëssen	v@s@n
wëssenschaftler	v@s@nSAftl6
wëssenschaftlerin	v@s@nSAftl@Rin
wëssenschaftlerinne	v@s@nSAftl@Rin@
wëssenschaftlerinnen	v@s@nSAftl@Rin@n
weste	v{st@
westen	v{st@n
wett	v{t
wette	v{t@
wetten	v{t@n
wetzstee	v{tsSte:
wetzsteen	v{tsSte:n
wibbele	vib@l@
wibbeleg	vib@l@s\
wibbelegem	vib@l@z\@m
wibbelegen	vib@l@z\@n
wibbelen	vib@l@n
wichs	viks
wichsbiischt	viksbi:St
wichsbiischten	viksbi:St@n
wichse	viks@
wichsen	viks@n
wichteg	vis\t@s\
widder	vid6
widderhuele	vid6hu@l@
widderhuelen	vid6hu@l@n
widderspréchs	vid6SpR@s\s
widdersprécht	vid6SpR@s\t
widderspriech	vid6SpRi@s\
widdersprieche	vid6SpRi@s\@
widderspriechen	vid6SpRi@s\@n
widderstoe	vid6Sto:@
widderstoen	vid6Sto:@n
wie	vi@
wieder	vi@d6
wiedere	vi@d@R@
wiedereg	vi@d@R@s\
wiederen	vi@d@R@n
wiel	vi@l
wiele	vi@l@
wielech	vi@l@s\
wielen	vi@l@n
wiem	vi@m
wien	vi@n
wierdeg	vi6d@s\
wiere	vi@R@
wieren	vi@R@n
wierfel	vi6f@l
wierfele	vi6f@l@
wierfelen	vi6f@l@n
wierk	vi6k
wierkdësch	vi6kd@S
wierke	vi6k@
wierken	vi6k@n
wierklech	vi6kl@s\
wierklechkeet	vi6kl@s\ke:t
wierkung	vi6kuN
wierme	vi6m@
wiermen	vi6m@n
wiermt	vi6mt
wiers	vi6s
wiert	vi6t
wiertchen	vi6ts\@n
wiertes	vi6t@s
wiertschaft	vi6tSAft
wierze	vi6ts@
wierzen	vi6ts@n
wiessele	vi@s@l@
wiesselen	vi@s@l@n
wiewe	vi@v@
wiewen	vi@v@n
wimmele	vim@l@
wimmelen	vim@l@n
wimper	vimp6
windjack	vintjAk
winker	viNk6
winne	vin@
winnen	vin@n
wirbelwand	viRb@lvAnt
wirschtche	viRSts\@
wirschtchen	viRSts\@n
wischer	viS6
wise	vi:z@
wisechampignon	vi:z@SA~:piJA~:
wisechampignone	vi:z@SA~:piJA~:@
wisechampignonen	vi:z@SA~:piJA~:@n
wisefest	vi:z@f{st
wisefester	vi:z@f{st6
wisel	viz@l
wiss	vis
witfra	vitfRa:
witmann	vitmAn
witz	vits
witzeg	vits@s\
wo	vo:
woch	voX
woe	vo:@
woen	vo:@n
woll	vol
wollef	vol@f
wollek	volek
wollent	vol@nt
won	vo:n
wonn	von
wonner	von6
wonnerbar	von6ba:R
wonnerbare	von6ba:R@
wonnerbart	von6ba:Rt
wonnere	von@R@
wonneren	von@R@n
wonnerschéin	von6S3In
wonnerwierk	von6vi6k
wonsch	vonS
woodlech	vo:dl@s\
wope	vo:p
wopen	vo:p@n
wopendéier	vo:p@nd3I6
wopendéiere	vo:p@nd3I@R@
wopendéieren	vo:p@nd3I@R@n
wou	v@U
wouduerjer	v@Udu6z\6
wouer	v@U6
wouerecht	v@U@R@s\t
woumadder	v@UmAd6
woumat	v@UmAt
wourënner	v@UR@n6
wourun	v@URun
wouscht	v@USt
wouvun	v@Ufun
wrack	vRAk
wuecht	vu@s\t
wued	vu@t
wuel	vu@l
wuer	vu6
wuerfir	vu6fi6
wuergéint	vu6g3Int
wuerhin	vu6hin
wuerm	vu6m
wuert	vu6t
wuerzel	vu6ts@l
wues	vu@s
wuesse	vu@s@
wuessen	vu@s@n
wuesskräijonge	vu@skR{:IjoN@
wuesskräijongen	vu@skR{:IjoN@n
wuesstem	vu@st@m
wull	vul
wunne	vun@
wunnen	vun@n
wunneng	vuneN
wupp	vup
wurscht	vuRSt
wüst	vy:st
xenophobem	kse:no:fo:b@m
xenophoben	kse:no:fo:b@n
xenophober	kse:no:fo:b6
xenophobie	kse:no:fo:bi:
xenophobt	kse:no:fo:pt
xylofon	ksilo:fo:n
xylofone	ksilo:fo:n@
xylofonen	ksilo:fo:n@n
xylofoner	ksilo:fon6
xylophon	ksilo:fo:n
xylophone	ksilo:fo:n@
xylophonen	ksilo:fo:n@n
xylophoner	ksilo:fo:n6
yoga	jo:ga:
yoghourt	joguRt
zaang	tsa:N
zaart	tsa:Rt
zack	tsAk
zäertlech	tsE:6tl@s\
zäertlechkeet	tsE:6tl@s\ke:t
zahnstocher	tsa:nStoX6
zäit	ts{:It
zäitgenëssesch	ts{:Itg@n@s@S
zäitschrëft	ts{:ItSR@ft
zäitweileg	ts{:ItvAIl@s\
zalot	tsAlo:t
zam	tsa:m
zäme	tsE:m@
zämen	tsE:m@n
zammermann	tsAm6mAn
zännbiischt	ts{nbi:St
zänndokter	ts{ndokt6
zännfleesch	ts{nfle:S
zännpasta	ts{npAsta:
zännseef	ts{nze:f
zännstëppler	ts{nSt@pl6
zännwéi	ts{nw3I
zant	tsAnt
zanter	tsAnt6
zantimeter	tsAntime:t6
zap	tsa:p
zape	tsa:p@
zapen	tsa:p@n
zappe	tsAp@
zappen	tsAp@n
zär	tsE:R
zare	tsa:R
zäsure	tsE:su:R@
zäsuren	tsE:zu:R@n
zaubere	tsAUb@R@
zauberei	tsAUb@RAI
zauberen	tsAUb@R@n
ze	z@
zebra	tse:bRa:
zebrasträif	tse:bRa:stR{:If
zecke	ts{k@
zécke	tsek@
zecken	ts{k@n
zécken	tsek@n
zeder	tse:d6
zee	tse:
zeeche	tse:s\@
zeechen	tse:s\@n
zeechne	tse:s\n@
zeechnen	tse:s\n@n
zeechner	tse:s\n6
zeechnerin	tse:s\n@Rin
zeechnung	tse:s\nuN
zeen	tse:n
zefridde	ts@fRid@
zefridden	ts@fRid@n
zeideg	tsAId@s\
zeie	tsAI@
zéie	ts3I@
zeien	tsAI@n
zéien	ts3I@n
zéif	ts3If
zeitung	tsAItuN
zejoer	ts@jo6
zejoert	ts@jo:6t
zelebréiert	tselebR3I6t
zelleri	ts{l@Ri:
zelt	ts{lt
zement	ts@m{nt
zëmmer	ts@m6
zemol	ts@mo:l
zemools	ts@mo:ls
zéng	tseN
zéngte	tseNt@
zéngten	tseNt@n
zënn	ts@n
zensur	ts{nzu:R
zensure	ts{nzu:R@
zensuren	ts{nzu:R@n
zënter	ts@nt6
zentral	ts{ntRa:l
zentrifugal	ts{ntRifu:ga:l
zentrifugale	ts{ntRifu:ga:l@
zentrifugalem	ts{ntRifu:ga:l@m
zentrifugalen	ts{ntRifu:ga:l@n
zentrifugaler	ts{ntRifu:ga:l6
zentrifugéierter	ts{ntRifu:g3I6t6
zentrifugen	ts{ntRifu:R@n
zentrum	ts{ntRum
zerbrieche	ts6bRi@s\@
zerbriechen	ts6bRi@s\@n
zerbriechlech	ts6bRi@s\l@s\
zerdrécke	ts6dRek@
zerdrécken	ts6dRek@n
zeremonie	tseRemoni:
zeremonië	tseRemoni:@
zeremonien	tseRemoni:@n
zerfatzt	ts6fAtst
zeriet	ts@Ri@t
zerkniwwele	ts6kniv@l@
zerkniwwelen	ts6kniv@l@n
zerkraazt	ts6kRa:tst
zermuele	ts6mu@l@
zermuelen	ts6mu@l@n
zerquetsche	ts6kw{tS@
zerquetschen	ts6kw{tS@n
zerräisse	ts6R{:Is@
zerräissen	ts6R{:Is@n
zerrappe	ts6RAp@
zerrappen	ts6RAp@n
zersaten	ts6za:t@n
zersater	ts6za:t6
zerschloe	ts6Slo:@
zerschloen	ts6Slo:@n
zerseetem	ts6ze:t@m
zerseeten	ts6ze:t@n
zerseeter	ts6ze:t6
zersidelt	ts6zi:d@lt
zersidelte	ts6zi:d@lt@
zersideltem	ts6zid@lt@m
zerstéiere	ts6St3I@R@
zerstéieren	ts6St3I@R@n
zerstreet	ts6StRe:t
zertéitschter	ts6t3ItSt6
zertifika	tsERtifika:
zertifikat	tsERtifika:t
zertifikater	tsERtifika:t6
zerwéiere	tsERv3I6@
zerwéieren	tsERv3I6@n
zerwéit	tsERv3It
zerwiss	tsERvis
zerwisser	tsERvis6
zerwujel	ts6vuz\@l
zerwujele	ts6vuz\@l@
zerwujelen	ts6vuz\@l@n
zerwujels	ts6vuz\@ls
zerwullte	ts6vult@
zerwulltem	ts6vult@m
zerwullten	ts6vult@n
zerwullter	ts6vult6
zësse	ts@s@
zëssen	ts@s@n
zesumme	ts@zum@
zesummebrieche	ts@zum@bRi@s\@
zesummebriechen	ts@zum@bRi@s\@n
zesummegepecht	ts@zum@g@p{s\t
zesummegepechte	ts@zum@g@p{s\t@
zesummen	ts@zum@n
zesummepeche	ts@zum@p{s\@
zesummepechen	ts@zum@p{s\@n
zesummeschäre	ts@zum@SE:R@
zesummeschären	ts@zum@SE:R@n
zesummesetze	ts@zum@s{ts@
zesummesetzen	ts@zum@s{ts@n
zetär	ts@tE:R
zevirkoums	ts@fi6k@Ums
zevirkoumt	ts@fi6k@Umt
zevirzekomme	ts@fi6ts@kom@
zevirzekommen	ts@fi6ts@kom@n
ziddere	tsid@R@
zidderen	tsid@R@n
ziedel	tsi@d@l
ziele	tsi@l@
zielen	tsi@l@n
zierkel	tsi6k@l
ziffer	tsif6
zifferblat	tsif6bla:t
zigar	tsiga:R
zigare	tsiga:R
zigaren	tsiga:R@n
zigarett	tsigAR{t
zigel	tsiz\@l
ziicht	tsi:s\t
ziichte	tsi:s\t@
ziichten	tsi:s\t@n
zil	tsi:l
zill	tsil
zille	tsil@
zillen	tsil@n
zilscheif	tsi:lSAIf
zimlech	tsiml@s\
zinema	tsinema:
zinnober	tsino:b6
zirkuléiere	tsiRkul3I@R@
zirkuléieren	tsiRkul3I@R@n
zirkus	tsiRkus
zitadell	tsitAd{l
zitadelle	tsitAd{l@
zitadellen	tsitAd{l@n
zitéiere	tsit3I@R@
zitéieren	tsit3I@R@n
zitroun	tsitR@Un
zivilsten	tsivilst@n
zivilster	tsivilst6
zivilt	tsivilt
ziwwi	tsivi:
ziwwie	tsivi:@
zocker	tsok6
zockerboun	tsok6b@Un
zockerdëppche	tsok6d@ps\@
zockerdëppchen	tsok6d@ps\@n
zockerwatt	tsok6vAt
zodi	tso:di:
zolidd	tsolit
zomm	tsom
zon	tso:n
zone	tso:n@
zonen	tso:n@n
zong	tsoN
zoo	tso:
zooen	tso:@n
zoolog	tso:lo:k
zoologe	tso:lo:g@
zoologen	tso:lo:g@n
zoologin	tso:lo:gin
zoologinne	tso:o:lo:gin@
zoologinnen	tso:o:lo:gin@n
zoom	zu:m
zoome	zu:m@
zoomen	zu:m@n
zooms	zu:ms
zoomt	zu:mt
zooss	tso:s
zoossiss	tso:sis
zopp	tsop
zoppeläffel	tsop@l{f@l
zort	tsORt
zou	ts@U
zoudecke	ts@Ud{k@
zoudecken	ts@Ud{k@n
zoudréie	ts@UdR3I@
zoudréien	ts@UdR3I@n
zoufall	ts@UfAl
zoufälleg	ts@Uf{l@s\
zougänglech	ts@Ug{Nl@s\
zougank	ts@UgANk
zougestoe	ts@Ug@Sto:@
zougestoen	ts@Ug@Sto:@n
zougi	ts@Ugi
zouginn	ts@Ugin
zouhuele	ts@Uhu@l@
zouhuelen	ts@Uhu@l@n
zoukënfteg	ts@Uk@nft@s\
zouknäppe	ts@Ukn{p@
zouknäppen	ts@Ukn{p@n
zoulaf	ts@Ula:f
zoulag	ts@Ula:X
zouléisseg	ts@Ul3Is@s\
zousätzlech	ts@Uz{tsl@s\
zouso	ts@Uso:
zouspäre	ts@USpE:R@
zouspären	ts@USpE:R@n
zoustand	ts@UStAnt
zouverléisseg	ts@Uf6l3Is@s\
zrass	tsRAs
zréck	tsRek
zréckbezuele	tsRekbetsu@l@
zréckbezuelen	tsRekbetsu@l@n
zréckgi	tsRekgi
zréckginn	tsRekgin
zréckkomme	tsRekkom@
zréckkommen	tsRekkom@n
zréckkréie	tsRekkR3I@
zréckkréien	tsRekkR3I@n
zréckschécke	tsRekSek@
zréckschécken	tsRekSek@n
zrécksprange	tsRekSpRAN@
zrécksprangen	tsRekSpRAN@n
zrécktriede	tsRektRi@d@
zrécktrieden	tsRektRi@d@n
zréckzéie	tsRekts3I@
zréckzéien	tsRekts3I@n
zuch	tsuX
zuel	tsu@l
zukënfteg	tsu:k@nft@s\
zukunft	tsu:kunft
zündung	tsynduN
zwang	tswAN
zwanzeg	tswAnts@s\
zwar	tswa:R
zweck	tsw{k
zwee	tswe:
zweedeiteg	tswe:dAIt@s\
zweemol	tswe:mo:l
zweete	tswe:t@
zweeten	tswe:t@n
zweetrangeg	tswe:tRAN@s\
zwéin	tsw3In
zweiwel	tswAIv@l
zweiwele	tswAIv@l@
zweiwelen	tswAIv@l@n
zweiwelhaft	tswAIv@lhAft
zwénge	tsweN@
zwéngen	tsweN@n
zwerg	tswERs\
zwerge	tswERs\@
zwergen	tswERz\@n
zwëschefall	tsw@S@fAl
zwëschegelant	tsw@S@g@lAnt
zwielef	tswi@l@f
zwillinge	tswiliN@
zwillingen	tswiliN@n
zwir	tswi6
zwire	tswi:R@
zwiren	tswi:R@n
zwirer	tswi:R6
zwispältegen	tswi:sp{lt@z\@n
zwispältegster	tswi:sp{lt@s\st6
zwispältegt	tswi:sp{lt@s\t
zwiwwel	tswiv@l
zwou	tsw@U
zykle	tsik@l
zyklen	tsikl@n
zyklesch	tsikl@S
zykleschen	tsikl@S@n
zyklescher	tsikl@S6
zyklescht	tsikl@St
zyklus	tsiklus
zyklusse	tsiklus@
zyklussen	tsiklus@n
zylinder	tsilind6
zynesch	tsi:n@S
zynescht	tsi:n@St
zyniker	tsi:nik6
zynikerin	tsi:nik@Rin
zynikerinne	tsi:nik@Rin@
zynikerinnen	tsi:nik@Rin@n
zynismus	tsinismus
zypress	tsipR{s
